GRIDCODE,ID,furb,frural,fpob, PobUrb, PobR, puT,prT, PobT
0			fraction
132969,12007, 0.0000000, 0.0128927, 0.0128927,     0,   174,      0,  13496,  13496
132970,12007, 0.0000000, 0.0065205, 0.0065205,     0,    88,      0,  13496,  13496
132972,12007, 0.0000000, 0.0106698, 0.0106698,     0,   144,      0,  13496,  13496
132973,12058, 0.0000000, 0.0015553, 0.0008741,     0,    47,  23549,  30220,  53769
132974,12058, 0.0000000, 0.0005625, 0.0003162,     0,    17,  23549,  30220,  53769
132975,12058, 0.0000000, 0.0085043, 0.0047797,     0,   257,  23549,  30220,  53769
132976,12006, 0.0000000, 0.0151345, 0.0151345,     0,    81,      0,   5352,   5352
132976,12058, 0.0000000, 0.0003640, 0.0002046,     0,    11,  23549,  30220,  53769
132978,12058, 0.0000000, 0.0154533, 0.0086853,     0,   467,  23549,  30220,  53769
132979,12058, 0.0000000, 0.0147584, 0.0082947,     0,   446,  23549,  30220,  53769
132980,12026, 0.0000000, 0.1105594, 0.1105594,     0,   757,      0,   6847,   6847
132980,12058, 0.0000000, 0.0059563, 0.0033477,     0,   180,  23549,  30220,  53769
132984,12026, 0.0000000, 0.1280853, 0.1280853,     0,   877,      0,   6847,   6847
132985,12017, 0.0000000, 0.0185024, 0.0101312,     0,   149,   6654,   8053,  14707
132985,12026, 0.0000000, 0.0005842, 0.0005842,     0,     4,      0,   6847,   6847
132986,12017, 0.0000000, 0.0014901, 0.0008159,     0,    12,   6654,   8053,  14707
132987,12017, 0.1477307, 0.0646964, 0.1022642,   983,   521,   6654,   8053,  14707
132994,12059, 0.0000000, 0.0794867, 0.0554972,     0,  1691,   9196,  21274,  30470
132998,12034, 0.0000000, 0.0185080, 0.0069853,     0,   261,  23262,  14102,  37364
132999,12034, 0.0000000, 0.0397816, 0.0150145,     0,   561,  23262,  14102,  37364
133000,12034, 0.0000000, 0.0694937, 0.0262285,     0,   980,  23262,  14102,  37364
133004,12034, 0.0000000, 0.0793504, 0.0299486,     0,  1119,  23262,  14102,  37364
133009,12008, 0.0000000, 0.0666907, 0.0666907,     0,   370,      0,   5548,   5548
133015,21087, 0.0000000, 0.2012411, 0.0896383,     0,  1135,   7022,   5640,  12662
133018,21032, 0.8152611, 0.6382166, 0.7069368,   406,   501,    498,    785,   1283
133022,21047, 0.0000000, 0.0004262, 0.0001051,     0,     2,  14344,   4693,  19037
133034,21024, 0.0000000, 0.0103627, 0.0042239,     0,     4,    561,    386,    947
133037,21113, 0.9651779, 0.0373775, 0.3046892,  1275,   122,   1321,   3264,   4585
133037,21059, 1.0000000, 0.0085878, 0.5790113,  1420,     9,   1420,   1048,   2468
133038,21009, 0.6785124, 0.0451128, 0.4267928,   821,    36,   1210,    798,   2008
133039,21009, 0.0892562, 0.0288221, 0.0652390,   108,    23,   1210,    798,   2008
133041,21003, 0.0000000, 0.0175203, 0.0077071,     0,   261,  18968,  14897,  33865
133042,21003, 0.0000000, 0.0533664, 0.0234756,     0,   795,  18968,  14897,  33865
133043,21003, 0.0000000, 0.0034906, 0.0015355,     0,    52,  18968,  14897,  33865
133044,21003, 0.5652151, 0.0055716, 0.3190314, 10721,    83,  18968,  14897,  33865
133045,21003, 0.1882644, 0.0535678, 0.1290123,  3571,   798,  18968,  14897,  33865
133049,21127, 0.1066208, 0.0328998, 0.0555997,   124,    86,   1163,   2614,   3777
133050,21127, 0.0000000, 0.2957154, 0.2046598,     0,   773,   1163,   2614,   3777
133053,20459, 0.0000000, 0.0812183, 0.0464389,     0,   208,   1918,   2561,   4479
133055,20459, 0.0000000, 0.0468567, 0.0267917,     0,   120,   1918,   2561,   4479
133056,20459, 0.0000000, 0.0417806, 0.0238893,     0,   107,   1918,   2561,   4479
133057,20459, 0.9144943, 0.0085904, 0.3965171,  1754,    22,   1918,   2561,   4479
133058,20459, 0.0855057, 0.0031238, 0.0384014,   164,     8,   1918,   2561,   4479
134028,12007, 0.0000000, 0.0084469, 0.0084469,     0,   114,      0,  13496,  13496
134029,12007, 0.0000000, 0.0026675, 0.0026675,     0,    36,      0,  13496,  13496
134030,12007, 0.0000000, 0.0196354, 0.0196354,     0,   265,      0,  13496,  13496
134031,12007, 0.0000000, 0.0254149, 0.0254149,     0,   343,      0,  13496,  13496
134032,12007, 0.0000000, 0.0001482, 0.0001482,     0,     2,      0,  13496,  13496
134033,12058, 0.0000000, 0.0185308, 0.0104149,     0,   560,  23549,  30220,  53769
134034,12058, 0.0000000, 0.0091661, 0.0051517,     0,   277,  23549,  30220,  53769
134035,12058, 0.0000000, 0.0018531, 0.0010415,     0,    56,  23549,  30220,  53769
134036,12058, 0.0000000, 0.0099934, 0.0056166,     0,   302,  23549,  30220,  53769
134037,12058, 0.0000000, 0.0118134, 0.0066395,     0,   357,  23549,  30220,  53769
134038,12058, 0.0000000, 0.0134017, 0.0075322,     0,   405,  23549,  30220,  53769
134040,12058, 0.0000000, 0.0377565, 0.0212204,     0,  1141,  23549,  30220,  53769
134041,12058, 0.0000000, 0.0031105, 0.0017482,     0,    94,  23549,  30220,  53769
134043,12026, 0.0000000, 0.2894698, 0.2894698,     0,  1982,      0,   6847,   6847
134047,12035, 0.0000000, 0.0108042, 0.0012681,     0,   178, 123888,  16475, 140363
134047,12017, 0.0338142, 0.0002484, 0.0154348,   225,     2,   6654,   8053,  14707
134048,12035, 0.0000000, 0.0012747, 0.0001496,     0,    21, 123888,  16475, 140363
134049,12017, 0.0000000, 0.0317894, 0.0174067,     0,   256,   6654,   8053,  14707
134050,12035, 0.0000000, 0.0201517, 0.0023653,     0,   332, 123888,  16475, 140363
134051,12035, 0.0000000, 0.1142944, 0.0134152,     0,  1883, 123888,  16475, 140363
134052,12059, 0.0000000, 0.0001410, 0.0000985,     0,     3,   9196,  21274,  30470
134052,12035, 0.0000000, 0.0010319, 0.0001211,     0,    17, 123888,  16475, 140363
134053,12059, 0.0104393, 0.0542916, 0.0410568,    96,  1155,   9196,  21274,  30470
134056,12059, 0.0000000, 0.0190373, 0.0132918,     0,   405,   9196,  21274,  30470
134057,12034, 0.0000000, 0.0238264, 0.0089926,     0,   336,  23262,  14102,  37364
134059,12034, 0.0000000, 0.0017728, 0.0006691,     0,    25,  23262,  14102,  37364
134060,12034, 0.0000000, 0.0153170, 0.0057810,     0,   216,  23262,  14102,  37364
134061,12034, 0.0000000, 0.0001418, 0.0000535,     0,     2,  23262,  14102,  37364
134063,12034, 0.0000000, 0.0846688, 0.0319559,     0,  1194,  23262,  14102,  37364
134064,12034, 0.0000000, 0.0004964, 0.0001873,     0,     7,  23262,  14102,  37364
134068,12008, 0.0000000, 0.0151406, 0.0151406,     0,    84,      0,   5548,   5548
134070,12008, 0.0000000, 0.0243331, 0.0243331,     0,   135,      0,   5548,   5548
134071,21087, 0.0000000, 0.0008865, 0.0003949,     0,     5,   7022,   5640,  12662
134072,21087, 0.0000000, 0.2367021, 0.1054336,     0,  1335,   7022,   5640,  12662
134077,21047, 0.0000000, 0.0302578, 0.0074592,     0,   142,  14344,   4693,  19037
134080,21047, 0.0000000, 0.2056254, 0.0506908,     0,   965,  14344,   4693,  19037
134082,21047, 0.0000000, 0.0004262, 0.0001051,     0,     2,  14344,   4693,  19037
134084,21047, 0.0000000, 0.0004262, 0.0001051,     0,     2,  14344,   4693,  19037
134085,21047, 0.0000000, 0.0008523, 0.0002101,     0,     4,  14344,   4693,  19037
134095,21059, 0.0000000, 0.2041985, 0.0867099,     0,   214,   1420,   1048,   2468
134096,21059, 0.0000000, 0.0047710, 0.0020259,     0,     5,   1420,   1048,   2468
134097,21059, 0.0000000, 0.1965649, 0.0834684,     0,   206,   1420,   1048,   2468
134097,21009, 0.1958678, 0.1591479, 0.1812749,   237,   127,   1210,    798,   2008
134098,21009, 0.0371901, 0.1428571, 0.0791833,    45,   114,   1210,    798,   2008
134099,21009, 0.0000000, 0.1165414, 0.0463147,     0,    93,   1210,    798,   2008
134100,21003, 0.0000000, 0.0324226, 0.0142625,     0,   483,  18968,  14897,  33865
134101,21003, 0.0000000, 0.0057730, 0.0025395,     0,    86,  18968,  14897,  33865
134102,21003, 0.0000000, 0.0059072, 0.0025986,     0,    88,  18968,  14897,  33865
134103,21003, 0.0320013, 0.0055045, 0.0203455,   607,    82,  18968,  14897,  33865
134104,21003, 0.0715943, 0.0888098, 0.0791673,  1358,  1323,  18968,  14897,  33865
134106,21196, 0.5778547, 0.4158215, 0.5294118,   668,   205,   1156,    493,   1649
134107,21127, 0.0000000, 0.1361897, 0.0942547,     0,   356,   1163,   2614,   3777
134107,21196, 0.0017301, 0.3245436, 0.0982414,     2,   160,   1156,    493,   1649
134108,21127, 0.8933792, 0.0260138, 0.2930897,  1039,    68,   1163,   2614,   3777
134109,21127, 0.0000000, 0.0328998, 0.0227694,     0,    86,   1163,   2614,   3777
134110,21190, 0.9626784, 0.1844262, 0.7982684,   877,    45,    911,    244,   1155
134111,20459, 0.0000000, 0.0078094, 0.0044653,     0,    20,   1918,   2561,   4479
134114,20459, 0.0000000, 0.0409996, 0.0234427,     0,   105,   1918,   2561,   4479
134115,20459, 0.0000000, 0.0941039, 0.0538067,     0,   241,   1918,   2561,   4479
134116,20459, 0.0000000, 0.0636470, 0.0363921,     0,   163,   1918,   2561,   4479
134117,20459, 0.0000000, 0.0007809, 0.0004465,     0,     2,   1918,   2561,   4479
135087,12007, 0.0000000, 0.0160047, 0.0160047,     0,   216,      0,  13496,  13496
135088,12007, 0.0000000, 0.0009632, 0.0009632,     0,    13,      0,  13496,  13496
135089,12007, 0.0000000, 0.0131150, 0.0131150,     0,   177,      0,  13496,  13496
135090,12007, 0.0000000, 0.0152638, 0.0152638,     0,   206,      0,  13496,  13496
135091,12007, 0.0000000, 0.0327504, 0.0327504,     0,   442,      0,  13496,  13496
135091,12058, 0.0000000, 0.0022833, 0.0012833,     0,    69,  23549,  30220,  53769
135092,12058, 0.0000000, 0.0060556, 0.0034034,     0,   183,  23549,  30220,  53769
135093,12058, 0.0000000, 0.0049305, 0.0027711,     0,   149,  23549,  30220,  53769
135095,12058, 0.0000000, 0.0002978, 0.0001674,     0,     9,  23549,  30220,  53769
135097,12058, 0.0000000, 0.0000331, 0.0000186,     0,     1,  23549,  30220,  53769
135098,12058, 0.0000000, 0.0116479, 0.0065465,     0,   352,  23549,  30220,  53769
135099,12058, 0.0000000, 0.0111185, 0.0062490,     0,   336,  23549,  30220,  53769
135100,12058, 0.0000000, 0.0216744, 0.0121817,     0,   655,  23549,  30220,  53769
135104,12017, 0.0000000, 0.0337762, 0.0184946,     0,   272,   6654,   8053,  14707
135106,12017, 0.0000000, 0.0494226, 0.0270619,     0,   398,   6654,   8053,  14707
135107,12017, 0.0000000, 0.0546380, 0.0299177,     0,   440,   6654,   8053,  14707
135109,12035, 0.0000000, 0.0332625, 0.0039042,     0,   548, 123888,  16475, 140363
135111,12035, 0.0000000, 0.0430349, 0.0050512,     0,   709, 123888,  16475, 140363
135111,12059, 0.0000000, 0.0007521, 0.0005251,     0,    16,   9196,  21274,  30470
135112,12059, 0.3537408, 0.0097772, 0.1135871,  3253,   208,   9196,  21274,  30470
135113,12059, 0.3199217, 0.0003290, 0.0967837,  2942,     7,   9196,  21274,  30470
135115,12034, 0.0000000, 0.1251595, 0.0472380,     0,  1765,  23262,  14102,  37364
135117,12034, 0.1360158, 0.0002836, 0.0847875,  3164,     4,  23262,  14102,  37364
135120,12034, 0.0000000, 0.0001418, 0.0000535,     0,     2,  23262,  14102,  37364
135129,21087, 0.0000000, 0.0349291, 0.0155584,     0,   197,   7022,   5640,  12662
135130,21087, 0.0000000, 0.2597518, 0.1157005,     0,  1465,   7022,   5640,  12662
135137,21073, 0.0000000, 0.5925508, 0.0604908,     0,   525,   7793,    886,   8679
135143,21047, 0.0000000, 0.0170467, 0.0042023,     0,    80,  14344,   4693,  19037
135144,21047, 0.0000000, 0.0019177, 0.0004728,     0,     9,  14344,   4693,  19037
135146,21047, 0.0000000, 0.0392073, 0.0096654,     0,   184,  14344,   4693,  19037
135148,21047, 0.0000000, 0.0072448, 0.0017860,     0,    34,  14344,   4693,  19037
135149,21047, 0.0000000, 0.0210952, 0.0052004,     0,    99,  14344,   4693,  19037
135152,21157, 0.0000000, 0.0030654, 0.0015890,     0,    18,   5456,   5872,  11328
135153,21059, 0.0000000, 0.0410305, 0.0174230,     0,    43,   1420,   1048,   2468
135153,21157, 0.0000000, 0.0028951, 0.0015007,     0,    17,   5456,   5872,  11328
135154,21059, 0.0000000, 0.3769084, 0.1600486,     0,   395,   1420,   1048,   2468
135154,21157, 0.0000000, 0.0923024, 0.0478460,     0,   542,   5456,   5872,  11328
135155,21059, 0.0000000, 0.0104962, 0.0044571,     0,    11,   1420,   1048,   2468
135156,21059, 0.0000000, 0.1574427, 0.0668558,     0,   165,   1420,   1048,   2468
135157,21009, 0.0000000, 0.4385965, 0.1743028,     0,   350,   1210,    798,   2008
135158,21009, 0.0000000, 0.0689223, 0.0273904,     0,    55,   1210,    798,   2008
135160,21003, 0.0000000, 0.0702826, 0.0309169,     0,  1047,  18968,  14897,  33865
135161,21003, 0.0000000, 0.0106733, 0.0046951,     0,   159,  18968,  14897,  33865
135162,21003, 0.0000000, 0.0442371, 0.0194596,     0,   659,  18968,  14897,  33865
135163,21003, 0.0000000, 0.0515540, 0.0226783,     0,   768,  18968,  14897,  33865
135164,21196, 0.0000000, 0.0709939, 0.0212250,     0,    35,   1156,    493,   1649
135164,21003, 0.0000000, 0.0581325, 0.0255721,     0,   866,  18968,  14897,  33865
135165,21196, 0.4204152, 0.1886410, 0.3511219,   486,    93,   1156,    493,   1649
135167,21127, 0.0000000, 0.0482020, 0.0333598,     0,   126,   1163,   2614,   3777
135168,21127, 0.0000000, 0.0263963, 0.0182685,     0,    69,   1163,   2614,   3777
135171,20459, 0.0000000, 0.0390472, 0.0223264,     0,   100,   1918,   2561,   4479
135174,20459, 0.0000000, 0.0160094, 0.0091538,     0,    41,   1918,   2561,   4479
135176,20459, 0.0000000, 0.1007419, 0.0576021,     0,   258,   1918,   2561,   4479
136146,12007, 0.0000000, 0.0166716, 0.0166716,     0,   225,      0,  13496,  13496
136147,12007, 0.0000000, 0.0069650, 0.0069650,     0,    94,      0,  13496,  13496
136148,12007, 0.0000000, 0.0273414, 0.0273414,     0,   369,      0,  13496,  13496
136149,12007, 0.0000000, 0.0034825, 0.0034825,     0,    47,      0,  13496,  13496
136150,12058, 0.0000000, 0.0139643, 0.0078484,     0,   422,  23549,  30220,  53769
136150,12007, 0.0000000, 0.0042976, 0.0042976,     0,    58,      0,  13496,  13496
136151,12058, 0.0000000, 0.0093647, 0.0052633,     0,   283,  23549,  30220,  53769
136152,12058, 0.0000000, 0.0030113, 0.0016924,     0,    91,  23549,  30220,  53769
136154,12058, 0.0000000, 0.0002316, 0.0001302,     0,     7,  23549,  30220,  53769
136155,12058, 0.0000000, 0.0534745, 0.0300545,     0,  1616,  23549,  30220,  53769
136156,12058, 0.0000000, 0.0080741, 0.0045379,     0,   244,  23549,  30220,  53769
136157,12058, 0.0000000, 0.0460291, 0.0258699,     0,  1391,  23549,  30220,  53769
136159,12058, 0.0000000, 0.0145268, 0.0081646,     0,   439,  23549,  30220,  53769
136163,12058, 0.0000000, 0.0307081, 0.0172590,     0,   928,  23549,  30220,  53769
136164,12017, 0.0000000, 0.0011176, 0.0006120,     0,     9,   6654,   8053,  14707
136166,12058, 0.0000000, 0.0047981, 0.0026967,     0,   145,  23549,  30220,  53769
136166,12035, 0.0000000, 0.1139302, 0.0133725,     0,  1877, 123888,  16475, 140363
136167,12035, 0.0000000, 0.0007284, 0.0000855,     0,    12, 123888,  16475, 140363
136168,12035, 0.0000000, 0.1123521, 0.0131872,     0,  1851, 123888,  16475, 140363
136169,12035, 0.0110503, 0.0460091, 0.0151536,  1369,   758, 123888,  16475, 140363
136170,12035, 0.0384702, 0.0043096, 0.0344606,  4766,    71, 123888,  16475, 140363
136172,12059, 0.0003262, 0.0007991, 0.0006564,     3,    17,   9196,  21274,  30470
136173,12059, 0.0000000, 0.0844693, 0.0589760,     0,  1797,   9196,  21274,  30470
136175,12034, 0.0000000, 0.0009219, 0.0003479,     0,    13,  23262,  14102,  37364
136177,12034, 0.0150460, 0.0007091, 0.0096349,   350,    10,  23262,  14102,  37364
136178,12034, 0.0000000, 0.0124805, 0.0047104,     0,   176,  23262,  14102,  37364
136179,12034, 0.0000000, 0.0431854, 0.0162991,     0,   609,  23262,  14102,  37364
136180,12034, 0.0000000, 0.0001418, 0.0000535,     0,     2,  23262,  14102,  37364
136184,12034, 0.0000000, 0.0887817, 0.0335082,     0,  1252,  23262,  14102,  37364
136187,21087, 0.0000000, 0.0008865, 0.0003949,     0,     5,   7022,   5640,  12662
136188,21087, 0.0000000, 0.0033688, 0.0015006,     0,    19,   7022,   5640,  12662
136190,21087, 0.0000000, 0.1093972, 0.0487285,     0,   617,   7022,   5640,  12662
136191,21087, 0.0000000, 0.0007092, 0.0003159,     0,     4,   7022,   5640,  12662
136197,21032, 0.0000000, 0.3617834, 0.2213562,     0,   284,    498,    785,   1283
136198,21047, 0.0000000, 0.0100149, 0.0024689,     0,    47,  14344,   4693,  19037
136201,21047, 0.0819855, 0.0006392, 0.0619320,  1176,     3,  14344,   4693,  19037
136212,21157, 0.0000000, 0.0027248, 0.0014124,     0,    16,   5456,   5872,  11328
136222,21003, 0.0000000, 0.0458482, 0.0201683,     0,   683,  18968,  14897,  33865
136226,21127, 0.0000000, 0.0260138, 0.0180037,     0,    68,   1163,   2614,   3777
136230,20459, 0.0000000, 0.1351035, 0.0772494,     0,   346,   1918,   2561,   4479
137205,12007, 0.0000000, 0.0066686, 0.0066686,     0,    90,      0,  13496,  13496
137206,12007, 0.0000000, 0.0184499, 0.0184499,     0,   249,      0,  13496,  13496
137208,12007, 0.0000000, 0.0093361, 0.0093361,     0,   126,      0,  13496,  13496
137209,12031, 0.0000000, 0.0207132, 0.0153944,     0,    97,   1618,   4683,   6301
137209,12007, 0.0000000, 0.0030379, 0.0030379,     0,    41,      0,  13496,  13496
137210,12058, 0.0000000, 0.0014560, 0.0008183,     0,    44,  23549,  30220,  53769
137211,12058, 0.0000000, 0.0022502, 0.0012647,     0,    68,  23549,  30220,  53769
137212,12058, 0.0000000, 0.0143944, 0.0080902,     0,   435,  23549,  30220,  53769
137214,12058, 0.0000000, 0.0172402, 0.0096896,     0,   521,  23549,  30220,  53769
137216,12058, 0.1620026, 0.0125083, 0.0779817,  3815,   378,  23549,  30220,  53769
137217,12058, 0.0131640, 0.0539709, 0.0360989,   310,  1631,  23549,  30220,  53769
137218,12058, 0.0000000, 0.0083058, 0.0046681,     0,   251,  23549,  30220,  53769
137221,12058, 0.0000000, 0.0373925, 0.0210158,     0,  1130,  23549,  30220,  53769
137222,12058, 0.0000000, 0.0201853, 0.0113448,     0,   610,  23549,  30220,  53769
137223,12058, 0.0000000, 0.0161152, 0.0090573,     0,   487,  23549,  30220,  53769
137224,12058, 0.0000000, 0.0149239, 0.0083877,     0,   451,  23549,  30220,  53769
137224,12035, 0.0000000, 0.0361760, 0.0042461,     0,   596, 123888,  16475, 140363
137226,12035, 0.0000000, 0.0271927, 0.0031917,     0,   448, 123888,  16475, 140363
137227,12035, 0.1521536, 0.0006070, 0.1343659, 18850,    10, 123888,  16475, 140363
137228,12035, 0.3994818, 0.0043096, 0.3530988, 49491,    71, 123888,  16475, 140363
137229,12035, 0.0436846, 0.0471017, 0.0440857,  5412,   776, 123888,  16475, 140363
137230,12035, 0.0006700, 0.1296510, 0.0158090,    83,  2136, 123888,  16475, 140363
137232,12034, 0.0000000, 0.0002836, 0.0001071,     0,     4,  23262,  14102,  37364
137233,12034, 0.0000000, 0.0000709, 0.0000268,     0,     1,  23262,  14102,  37364
137234,12034, 0.0000000, 0.0495674, 0.0187078,     0,   699,  23262,  14102,  37364
137237,12034, 0.0000000, 0.0000709, 0.0000268,     0,     1,  23262,  14102,  37364
137240,12034, 0.0000000, 0.0603461, 0.0227759,     0,   851,  23262,  14102,  37364
137246,21087, 0.0000000, 0.0007092, 0.0003159,     0,     4,   7022,   5640,  12662
137248,21087, 0.0000000, 0.0257092, 0.0114516,     0,   145,   7022,   5640,  12662
137252,21087, 0.9720877, 0.0455674, 0.5593903,  6826,   257,   7022,   5640,  12662
137255,21087, 0.0000000, 0.0030142, 0.0013426,     0,    17,   7022,   5640,  12662
137256,21047, 0.0000000, 0.0392073, 0.0096654,     0,   184,  14344,   4693,  19037
137257,21047, 0.0000000, 0.0008523, 0.0002101,     0,     4,  14344,   4693,  19037
137258,21047, 0.0000000, 0.0004262, 0.0001051,     0,     2,  14344,   4693,  19037
137258,21073, 0.0000000, 0.0417607, 0.0042632,     0,    37,   7793,    886,   8679
137259,21047, 0.0000000, 0.0831025, 0.0204864,     0,   390,  14344,   4693,  19037
137260,21047, 0.0122699, 0.0031962, 0.0100331,   176,    15,  14344,   4693,  19037
137261,21047, 0.0357641, 0.0049009, 0.0281557,   513,    23,  14344,   4693,  19037
137262,21047, 0.0023006, 0.0255700, 0.0080370,    33,   120,  14344,   4693,  19037
137271,21157, 0.0000000, 0.0580722, 0.0301024,     0,   341,   5456,   5872,  11328
137272,21157, 0.1926320, 0.0068120, 0.0963100,  1051,    40,   5456,   5872,  11328
137273,21157, 0.0916422, 0.0102180, 0.0494350,   500,    60,   5456,   5872,  11328
137274,21157, 0.0000000, 0.0664169, 0.0344280,     0,   390,   5456,   5872,  11328
137275,21157, 0.0000000, 0.1760899, 0.0912782,     0,  1034,   5456,   5872,  11328
137277,21003, 0.0000000, 0.0002685, 0.0001181,     0,     4,  18968,  14897,  33865
137278,21003, 0.0000000, 0.0008055, 0.0003543,     0,    12,  18968,  14897,  33865
137280,21003, 0.0000000, 0.0003356, 0.0001476,     0,     5,  18968,  14897,  33865
137281,21147, 0.0000000, 0.0005438, 0.0001682,     0,     1,   4105,   1839,   5944
137289,21190, 0.0000000, 0.8155738, 0.1722944,     0,   199,    911,    244,   1155
137290,21018, 0.0000000, 0.1476413, 0.1098018,     0,   410,    957,   2777,   3734
138264,12007, 0.0000000, 0.0784677, 0.0784677,     0,  1059,      0,  13496,  13496
138265,12031, 0.0000000, 0.0155883, 0.0115855,     0,    73,   1618,   4683,   6301
138266,12007, 0.0000000, 0.0025934, 0.0025934,     0,    35,      0,  13496,  13496
138266,12031, 0.0000000, 0.0277600, 0.0206316,     0,   130,   1618,   4683,   6301
138267,12031, 0.0000000, 0.0010677, 0.0007935,     0,     5,   1618,   4683,   6301
138270,12058, 0.0000000, 0.0019193, 0.0010787,     0,    58,  23549,  30220,  53769
138272,12058, 0.0000000, 0.0192919, 0.0108427,     0,   583,  23549,  30220,  53769
138274,12058, 0.0000000, 0.0153210, 0.0086109,     0,   463,  23549,  30220,  53769
138277,12058, 0.0000000, 0.0071476, 0.0040172,     0,   216,  23549,  30220,  53769
138278,12058, 0.0000000, 0.0064527, 0.0036266,     0,   195,  23549,  30220,  53769
138279,12058, 0.0000000, 0.0037723, 0.0021202,     0,   114,  23549,  30220,  53769
138283,12058, 0.0000000, 0.0059232, 0.0033291,     0,   179,  23549,  30220,  53769
138285,12035, 0.0000000, 0.0050379, 0.0005913,     0,    83, 123888,  16475, 140363
138286,12035, 0.0756732, 0.0172989, 0.0688215,  9375,   285, 123888,  16475, 140363
138287,12035, 0.1992929, 0.0821851, 0.1855475, 24690,  1354, 123888,  16475, 140363
138288,12035, 0.0295428, 0.0044310, 0.0265953,  3660,    73, 123888,  16475, 140363
138298,12034, 0.0000000, 0.0001418, 0.0000535,     0,     2,  23262,  14102,  37364
138299,12034, 0.0000000, 0.0002836, 0.0001071,     0,     4,  23262,  14102,  37364
138301,12034, 0.0000000, 0.0001418, 0.0000535,     0,     2,  23262,  14102,  37364
138309,21087, 0.0000000, 0.0102837, 0.0045806,     0,    58,   7022,   5640,  12662
138311,21087, 0.0000000, 0.0132979, 0.0059232,     0,    75,   7022,   5640,  12662
138316,21073, 0.0000000, 0.0090293, 0.0009218,     0,     8,   7793,    886,   8679
138317,21073, 0.0120621, 0.0180587, 0.0126743,    94,    16,   7793,    886,   8679
138318,21047, 0.0000000, 0.0019177, 0.0004728,     0,     9,  14344,   4693,  19037
138319,21047, 0.0000000, 0.0364372, 0.0089825,     0,   171,  14344,   4693,  19037
138321,21047, 0.0000000, 0.1427658, 0.0351946,     0,   670,  14344,   4693,  19037
138322,21047, 0.0000000, 0.0334541, 0.0082471,     0,   157,  14344,   4693,  19037
138329,21157, 0.0000000, 0.0304837, 0.0158016,     0,   179,   5456,   5872,  11328
138331,21157, 0.4818548, 0.0003406, 0.2322564,  2629,     2,   5456,   5872,  11328
138332,21157, 0.2336877, 0.0163488, 0.1210275,  1275,    96,   5456,   5872,  11328
138333,21157, 0.0000000, 0.0083447, 0.0043256,     0,    49,   5456,   5872,  11328
138337,21147, 0.0000000, 0.0092442, 0.0028600,     0,    17,   4105,   1839,   5944
138353,21018, 0.0000000, 0.0018005, 0.0013390,     0,     5,    957,   2777,   3734
139324,12031, 0.0000000, 0.1522528, 0.1131566,     0,   713,   1618,   4683,   6301
139325,12031, 0.0000000, 0.0655563, 0.0487224,     0,   307,   1618,   4683,   6301
139326,12031, 0.0000000, 0.0049114, 0.0036502,     0,    23,   1618,   4683,   6301
139327,12058, 0.0000000, 0.0013567, 0.0007625,     0,    41,  23549,  30220,  53769
139327,12031, 0.0327565, 0.0296818, 0.0304714,    53,   139,   1618,   4683,   6301
139328,12058, 0.0000000, 0.0027465, 0.0015436,     0,    83,  23549,  30220,  53769
139328,12031, 0.0000000, 0.0469784, 0.0349151,     0,   220,   1618,   4683,   6301
139329,12058, 0.0000000, 0.0059563, 0.0033477,     0,   180,  23549,  30220,  53769
139329,12031, 0.0000000, 0.0151612, 0.0112681,     0,    71,   1618,   4683,   6301
139330,12058, 0.0000000, 0.0104567, 0.0058770,     0,   316,  23549,  30220,  53769
139331,12058, 0.0000000, 0.0049967, 0.0028083,     0,   151,  23549,  30220,  53769
139332,12058, 0.0000000, 0.0222369, 0.0124979,     0,   672,  23549,  30220,  53769
139333,12058, 0.0000000, 0.0204500, 0.0114936,     0,   618,  23549,  30220,  53769
139334,12058, 0.0000000, 0.0033422, 0.0018784,     0,   101,  23549,  30220,  53769
139335,12058, 0.0000000, 0.0079087, 0.0044449,     0,   239,  23549,  30220,  53769
139337,12058, 0.0000000, 0.0023825, 0.0013391,     0,    72,  23549,  30220,  53769
139337,12037, 0.0000000, 0.2799317, 0.1738604,     0,  1148,   2502,   4101,   6603
139340,12058, 0.0000000, 0.0069821, 0.0039242,     0,   211,  23549,  30220,  53769
139341,12055, 0.0000000, 0.0112912, 0.0035943,     0,   374,  70930,  33123, 104053
139341,12058, 0.0000000, 0.0071476, 0.0040172,     0,   216,  23549,  30220,  53769
139343,12055, 0.0000000, 0.0116535, 0.0037096,     0,   386,  70930,  33123, 104053
139346,12035, 0.0000000, 0.1047041, 0.0122896,     0,  1725, 123888,  16475, 140363
139347,12035, 0.0000000, 0.0182701, 0.0021444,     0,   301, 123888,  16475, 140363
139348,12015, 0.0000000, 0.0003599, 0.0001576,     0,     2,   7131,   5557,  12688
139359,12034, 0.0000000, 0.0009219, 0.0003479,     0,    13,  23262,  14102,  37364
139360,12034, 0.0000000, 0.0135442, 0.0051119,     0,   191,  23262,  14102,  37364
139360,12008, 0.0000000, 0.1313987, 0.1313987,     0,   729,      0,   5548,   5548
139362,12034, 0.0000000, 0.0023401, 0.0008832,     0,    33,  23262,  14102,  37364
139363,17025, 0.0000000, 0.0051515, 0.0021564,     0,    68,  18334,  13200,  31534
139368,21087, 0.0000000, 0.0090426, 0.0040278,     0,    51,   7022,   5640,  12662
139369,21087, 0.0000000, 0.0049645, 0.0022113,     0,    28,   7022,   5640,  12662
139370,21087, 0.0000000, 0.0058511, 0.0026062,     0,    33,   7022,   5640,  12662
139371,21160, 0.0000000, 0.1766523, 0.0916373,     0,   286,   1502,   1619,   3121
139373,21073, 0.0000000, 0.0180587, 0.0018435,     0,    16,   7793,    886,   8679
139374,21073, 0.0000000, 0.2042889, 0.0208549,     0,   181,   7793,    886,   8679
139376,21073, 0.5045553, 0.0327314, 0.4563890,  3932,    29,   7793,    886,   8679
139377,21047, 0.0000000, 0.1069678, 0.0263697,     0,   502,  14344,   4693,  19037
139380,21047, 0.0000000, 0.0006392, 0.0001576,     0,     3,  14344,   4693,  19037
139381,21047, 0.0000000, 0.0021308, 0.0005253,     0,    10,  14344,   4693,  19037
139382,21085, 0.0000000, 0.0104530, 0.0019368,     0,   141,  59310,  13489,  72799
139383,21085, 0.0000000, 0.0321002, 0.0059479,     0,   433,  59310,  13489,  72799
139384,21085, 0.0000000, 0.0100823, 0.0018682,     0,   136,  59310,  13489,  72799
139385,21157, 0.0000000, 0.0185627, 0.0096222,     0,   109,   5456,   5872,  11328
139386,21157, 0.0000000, 0.0010218, 0.0005297,     0,     6,   5456,   5872,  11328
139387,21157, 0.0000000, 0.1227861, 0.0636476,     0,   721,   5456,   5872,  11328
139388,21157, 0.0000000, 0.0519414, 0.0269244,     0,   305,   5456,   5872,  11328
139389,21157, 0.0000000, 0.0020436, 0.0010593,     0,    12,   5456,   5872,  11328
139390,21157, 0.0000000, 0.0001703, 0.0000883,     0,     1,   5456,   5872,  11328
139391,21157, 0.0000000, 0.0023842, 0.0012359,     0,    14,   5456,   5872,  11328
139392,21157, 0.0000000, 0.0265668, 0.0137712,     0,   156,   5456,   5872,  11328
139394,21147, 0.0000000, 0.0326264, 0.0100942,     0,    60,   4105,   1839,   5944
139395,21147, 0.0000000, 0.0027189, 0.0008412,     0,     5,   4105,   1839,   5944
139396,21147, 0.0000000, 0.0048940, 0.0015141,     0,     9,   4105,   1839,   5944
139397,21147, 0.0000000, 0.1087548, 0.0336474,     0,   200,   4105,   1839,   5944
139398,21147, 0.0000000, 0.0065253, 0.0020188,     0,    12,   4105,   1839,   5944
139404,21169, 0.0000000, 0.0117723, 0.0089364,     0,   183,   4933,  15545,  20478
139409,21018, 0.0000000, 0.1811307, 0.1347081,     0,   503,    957,   2777,   3734
140382,12031, 0.0000000, 0.0397181, 0.0295191,     0,   186,   1618,   4683,   6301
140384,12031, 0.0000000, 0.0777280, 0.0577686,     0,   364,   1618,   4683,   6301
140385,12031, 0.0000000, 0.0352338, 0.0261863,     0,   165,   1618,   4683,   6301
140386,12031, 0.9672435, 0.0042708, 0.2515474,  1565,    20,   1618,   4683,   6301
140387,12031, 0.0000000, 0.0140935, 0.0104745,     0,    66,   1618,   4683,   6301
140388,12058, 0.0000000, 0.0063865, 0.0035894,     0,   193,  23549,  30220,  53769
140388,12031, 0.0000000, 0.0032031, 0.0023806,     0,    15,   1618,   4683,   6301
140389,12058, 0.0000000, 0.0038385, 0.0021574,     0,   116,  23549,  30220,  53769
140390,12047, 0.0000000, 0.0226584, 0.0203497,     0,   142,    711,   6267,   6978
140391,12058, 0.0000000, 0.0038385, 0.0021574,     0,   116,  23549,  30220,  53769
140392,12058, 0.0000000, 0.0001985, 0.0001116,     0,     6,  23549,  30220,  53769
140393,12058, 0.0000000, 0.0129054, 0.0072533,     0,   390,  23549,  30220,  53769
140394,12058, 0.0000000, 0.0049636, 0.0027897,     0,   150,  23549,  30220,  53769
140395,12037, 0.0000000, 0.0109729, 0.0068151,     0,    45,   2502,   4101,   6603
140395,12058, 0.0000000, 0.0063865, 0.0035894,     0,   193,  23549,  30220,  53769
140398,12037, 0.0000000, 0.0360888, 0.0224141,     0,   148,   2502,   4101,   6603
140399,12037, 0.0000000, 0.0004877, 0.0003029,     0,     2,   2502,   4101,   6603
140400,12055, 0.0000000, 0.0335416, 0.0106773,     0,  1111,  70930,  33123, 104053
140402,12055, 0.0000000, 0.0320623, 0.0102063,     0,  1062,  70930,  33123, 104053
140404,12035, 0.0000000, 0.0009712, 0.0001140,     0,    16, 123888,  16475, 140363
140405,12055, 0.0000000, 0.0177520, 0.0056510,     0,   588,  70930,  33123, 104053
140406,12015, 0.0000000, 0.0529062, 0.0231715,     0,   294,   7131,   5557,  12688
140407,12015, 0.0000000, 0.0350909, 0.0153689,     0,   195,   7131,   5557,  12688
140413,12015, 0.0000000, 0.0012597, 0.0005517,     0,     7,   7131,   5557,  12688
140422,17025, 0.0000000, 0.0085606, 0.0035834,     0,   113,  18334,  13200,  31534
140423,17025, 0.0000000, 0.0091667, 0.0038371,     0,   121,  18334,  13200,  31534
140426,21087, 0.0000000, 0.0120567, 0.0053704,     0,    68,   7022,   5640,  12662
140428,21087, 0.0000000, 0.0210993, 0.0093982,     0,   119,   7022,   5640,  12662
140429,21087, 0.0000000, 0.0005319, 0.0002369,     0,     3,   7022,   5640,  12662
140430,21160, 0.0000000, 0.0061767, 0.0032041,     0,    10,   1502,   1619,   3121
140433,21073, 0.0000000, 0.0203160, 0.0020740,     0,    18,   7793,    886,   8679
140434,21073, 0.0000000, 0.0428894, 0.0043784,     0,    38,   7793,    886,   8679
140434,21047, 0.0000000, 0.0004262, 0.0001051,     0,     2,  14344,   4693,  19037
140435,21047, 0.0000000, 0.0012785, 0.0003152,     0,     6,  14344,   4693,  19037
140443,21085, 0.0000000, 0.0069686, 0.0012912,     0,    94,  59310,  13489,  72799
140444,21157, 0.0000000, 0.0006812, 0.0003531,     0,     4,   5456,   5872,  11328
140446,21157, 0.0000000, 0.0005109, 0.0002648,     0,     3,   5456,   5872,  11328
140447,21157, 0.0000000, 0.0010218, 0.0005297,     0,     6,   5456,   5872,  11328
140448,21157, 0.0000000, 0.0481948, 0.0249823,     0,   283,   5456,   5872,  11328
140449,21157, 0.0000000, 0.0119210, 0.0061794,     0,    70,   5456,   5872,  11328
140450,21157, 0.0000000, 0.0064714, 0.0033545,     0,    38,   5456,   5872,  11328
140450,21042, 0.0000000, 0.0405634, 0.0235140,     0,    72,   1287,   1775,   3062
140452,21157, 0.0000000, 0.0652248, 0.0338100,     0,   383,   5456,   5872,  11328
140452,21042, 0.0000000, 0.0174648, 0.0101241,     0,    31,   1287,   1775,   3062
140456,21147, 0.0000000, 0.0984231, 0.0304509,     0,   181,   4105,   1839,   5944
140457,21147, 0.0000000, 0.0141381, 0.0043742,     0,    26,   4105,   1839,   5944
140458,21147, 0.0012180, 0.6818923, 0.2118102,     5,  1254,   4105,   1839,   5944
140460,21147, 0.0000000, 0.0027189, 0.0008412,     0,     5,   4105,   1839,   5944
140462,21169, 0.0000000, 0.0004503, 0.0003418,     0,     7,   4933,  15545,  20478
140468,21018, 0.1556949, 0.0072020, 0.0452598,   149,    20,    957,   2777,   3734
140470,21018, 0.0000000, 0.0615772, 0.0457954,     0,   171,    957,   2777,   3734
140471,21018, 0.0000000, 0.0205257, 0.0152651,     0,    57,    957,   2777,   3734
141441,12031, 0.0000000, 0.0029895, 0.0022219,     0,    14,   1618,   4683,   6301
141441,15105, 0.0000000, 0.0035350, 0.0035350,     0,   105,      0,  29703,  29703
141442,12031, 0.0000000, 0.0277600, 0.0206316,     0,   130,   1618,   4683,   6301
141443,12031, 0.0000000, 0.0418535, 0.0311062,     0,   196,   1618,   4683,   6301
141444,12031, 0.0000000, 0.0085415, 0.0063482,     0,    40,   1618,   4683,   6301
141445,12058, 0.0000000, 0.0050298, 0.0028269,     0,   152,  23549,  30220,  53769
141445,12031, 0.0000000, 0.0149477, 0.0111093,     0,    70,   1618,   4683,   6301
141446,12031, 0.0000000, 0.0119581, 0.0088875,     0,    56,   1618,   4683,   6301
141447,12058, 0.0000000, 0.0205824, 0.0115680,     0,   622,  23549,  30220,  53769
141447,12031, 0.0000000, 0.1802264, 0.1339470,     0,   844,   1618,   4683,   6301
141448,12058, 0.0000000, 0.0009265, 0.0005207,     0,    28,  23549,  30220,  53769
141449,12047, 0.0000000, 0.0065422, 0.0058756,     0,    41,    711,   6267,   6978
141449,12058, 0.0000000, 0.0045003, 0.0025293,     0,   136,  23549,  30220,  53769
141450,12047, 0.0000000, 0.0169140, 0.0151906,     0,   106,    711,   6267,   6978
141450,12058, 0.0000000, 0.0024487, 0.0013763,     0,    74,  23549,  30220,  53769
141451,12058, 0.0000000, 0.0049967, 0.0028083,     0,   151,  23549,  30220,  53769
141452,12058, 0.0000000, 0.0029451, 0.0016552,     0,    89,  23549,  30220,  53769
141453,12037, 0.0000000, 0.0092660, 0.0057550,     0,    38,   2502,   4101,   6603
141454,12037, 0.0000000, 0.2099488, 0.1303953,     0,   861,   2502,   4101,   6603
141455,12037, 0.0000000, 0.0026823, 0.0016659,     0,    11,   2502,   4101,   6603
141456,12037, 0.0000000, 0.0304804, 0.0189308,     0,   125,   2502,   4101,   6603
141458,12037, 0.0000000, 0.0777859, 0.0483114,     0,   319,   2502,   4101,   6603
141460,12055, 0.0000000, 0.0253600, 0.0080728,     0,   840,  70930,  33123, 104053
141462,12055, 0.0000000, 0.0319717, 0.0101775,     0,  1059,  70930,  33123, 104053
141466,12015, 0.0000000, 0.0082778, 0.0036255,     0,    46,   7131,   5557,  12688
141468,12015, 0.5293788, 0.0023394, 0.2985498,  3775,    13,   7131,   5557,  12688
141471,12015, 0.0000000, 0.0008998, 0.0003941,     0,     5,   7131,   5557,  12688
141473,12015, 0.0000000, 0.0030592, 0.0013398,     0,    17,   7131,   5557,  12688
141476,17025, 0.0000000, 0.0340909, 0.0142703,     0,   450,  18334,  13200,  31534
141482,17025, 0.0000000, 0.0645455, 0.0270185,     0,   852,  18334,  13200,  31534
141484,17025, 0.0000000, 0.0079545, 0.0033297,     0,   105,  18334,  13200,  31534
141489,21160, 0.0000000, 0.0444719, 0.0230695,     0,    72,   1502,   1619,   3121
141490,21160, 0.0000000, 0.0018530, 0.0009612,     0,     3,   1502,   1619,   3121
141491,21073, 0.0301553, 0.0112867, 0.0282291,   235,    10,   7793,    886,   8679
141492,21073, 0.0091107, 0.0090293, 0.0091024,    71,     8,   7793,    886,   8679
141493,21047, 0.2163274, 0.0031962, 0.1637863,  3103,    15,  14344,   4693,  19037
141493,17003, 0.0000000, 0.0002409, 0.0000594,     0,     2,  25392,   8303,  33695
141494,21047, 0.0421082, 0.0031962, 0.0325156,   604,    15,  14344,   4693,  19037
141494,21051, 0.0000000, 0.0495550, 0.0193605,     0,   657,  20677,  13258,  33935
141498,21051, 0.0000000, 0.0013577, 0.0005304,     0,    18,  20677,  13258,  33935
141499,21051, 0.0000000, 0.0033942, 0.0013261,     0,    45,  20677,  13258,  33935
141500,21085, 0.0000000, 0.0121581, 0.0022528,     0,   164,  59310,  13489,  72799
141501,21085, 0.0000000, 0.0135666, 0.0025138,     0,   183,  59310,  13489,  72799
141502,21085, 0.0000000, 0.0019275, 0.0003571,     0,    26,  59310,  13489,  72799
141504,21157, 0.0000000, 0.0146458, 0.0075918,     0,    86,   5456,   5872,  11328
141504,21085, 0.0000000, 0.0047446, 0.0008791,     0,    64,  59310,  13489,  72799
141505,21157, 0.0000000, 0.0047684, 0.0024718,     0,    28,   5456,   5872,  11328
141506,21157, 0.0000000, 0.0081744, 0.0042373,     0,    48,   5456,   5872,  11328
141508,21042, 0.0000000, 0.0912676, 0.0529066,     0,   162,   1287,   1775,   3062
141511,21042, 0.0000000, 0.1481690, 0.0858916,     0,   263,   1287,   1775,   3062
141513,21042, 0.0000000, 0.0180282, 0.0104507,     0,    32,   1287,   1775,   3062
141514,21147, 0.0000000, 0.0065253, 0.0020188,     0,    12,   4105,   1839,   5944
141516,21147, 0.0000000, 0.0043502, 0.0013459,     0,     8,   4105,   1839,   5944
141517,21147, 0.9683313, 0.0130506, 0.6727793,  3975,    24,   4105,   1839,   5944
141521,21169, 0.0000000, 0.1221615, 0.0927337,     0,  1899,   4933,  15545,  20478
141524,21037, 0.8078704, 0.0172579, 0.4553228,  1047,    18,   1296,   1043,   2339
141525,21037, 0.0000000, 0.5963567, 0.2659256,     0,   622,   1296,   1043,   2339
141527,21018, 0.8349007, 0.0208858, 0.2295126,   799,    58,    957,   2777,   3734
141528,21018, 0.0094044, 0.0140439, 0.0128548,     9,    39,    957,   2777,   3734
142500,15105, 0.0000000, 0.0049153, 0.0049153,     0,   146,      0,  29703,  29703
142501,12031, 0.0000000, 0.0021354, 0.0015870,     0,    10,   1618,   4683,   6301
142501,15105, 0.0000000, 0.0008753, 0.0008753,     0,    26,      0,  29703,  29703
142503,12031, 0.0000000, 0.1095452, 0.0814156,     0,   513,   1618,   4683,   6301
142504,12031, 0.0000000, 0.0079009, 0.0058721,     0,    37,   1618,   4683,   6301
142506,12031, 0.0000000, 0.0134529, 0.0099984,     0,    63,   1618,   4683,   6301
142506,12058, 0.0000000, 0.0022833, 0.0012833,     0,    69,  23549,  30220,  53769
142507,12058, 0.0000000, 0.0071476, 0.0040172,     0,   216,  23549,  30220,  53769
142508,12058, 0.0000000, 0.0002978, 0.0001674,     0,     9,  23549,  30220,  53769
142509,12047, 0.0000000, 0.0702090, 0.0630553,     0,   440,    711,   6267,   6978
142510,12058, 0.0000000, 0.0016876, 0.0009485,     0,    51,  23549,  30220,  53769
142510,12047, 0.0000000, 0.0130844, 0.0117512,     0,    82,    711,   6267,   6978
142511,12047, 0.0000000, 0.0501037, 0.0449986,     0,   314,    711,   6267,   6978
142512,12047, 0.0000000, 0.0086166, 0.0077386,     0,    54,    711,   6267,   6978
142513,12037, 0.0000000, 0.1597171, 0.0991973,     0,   655,   2502,   4101,   6603
142514,12037, 0.0003997, 0.0156059, 0.0098440,     1,    64,   2502,   4101,   6603
142517,12037, 0.0000000, 0.0153621, 0.0095411,     0,    63,   2502,   4101,   6603
142518,12055, 0.0000000, 0.0038644, 0.0012301,     0,   128,  70930,  33123, 104053
142519,12055, 0.0000000, 0.0182351, 0.0058047,     0,   604,  70930,  33123, 104053
142520,12055, 0.0000000, 0.0418440, 0.0133201,     0,  1386,  70930,  33123, 104053
142521,12055, 0.0444805, 0.0000604, 0.0303403,  3155,     2,  70930,  33123, 104053
142527,12015, 0.3804516, 0.0446284, 0.2333701,  2713,   248,   7131,   5557,  12688
142530,12015, 0.0000000, 0.0167356, 0.0073298,     0,    93,   7131,   5557,  12688
142530,17017, 0.0000000, 0.0097278, 0.0016075,     0,    99,  51408,  10177,  61585
142531,17017, 0.0000000, 0.0114965, 0.0018998,     0,   117,  51408,  10177,  61585
142532,17017, 0.0119826, 0.0015722, 0.0102622,   616,    16,  51408,  10177,  61585
142536,12008, 0.0000000, 0.0018025, 0.0018025,     0,    10,      0,   5548,   5548
142537,12008, 0.0000000, 0.0016222, 0.0016222,     0,     9,      0,   5548,   5548
142537,17025, 0.0000000, 0.0162121, 0.0067863,     0,   214,  18334,  13200,  31534
142539,17025, 0.0000000, 0.0275758, 0.0115431,     0,   364,  18334,  13200,  31534
142543,17025, 0.0000000, 0.0165152, 0.0069132,     0,   218,  18334,  13200,  31534
142547,21160, 0.0000000, 0.0074120, 0.0038449,     0,    12,   1502,   1619,   3121
142549,21160, 0.5379494, 0.0018530, 0.2598526,   808,     3,   1502,   1619,   3121
142550,21160, 0.4400799, 0.0154416, 0.2198014,   661,    25,   1502,   1619,   3121
142550,17003, 0.0000000, 0.0014453, 0.0003561,     0,    12,  25392,   8303,  33695
142551,17003, 0.0000000, 0.0256534, 0.0063214,     0,   213,  25392,   8303,  33695
142553,21047, 0.0158951, 0.0364372, 0.0209592,   228,   171,  14344,   4693,  19037
142554,21051, 0.0000000, 0.1046161, 0.0408723,     0,  1387,  20677,  13258,  33935
142555,21051, 0.0000000, 0.0280585, 0.0109621,     0,   372,  20677,  13258,  33935
142559,21085, 0.0000000, 0.0045963, 0.0008517,     0,    62,  59310,  13489,  72799
142560,21085, 0.0000000, 0.0122322, 0.0022665,     0,   165,  59310,  13489,  72799
142561,21085, 0.0000000, 0.0013344, 0.0002473,     0,    18,  59310,  13489,  72799
142563,21157, 0.0000000, 0.0085150, 0.0044138,     0,    50,   5456,   5872,  11328
142563,21085, 0.0000000, 0.0042257, 0.0007830,     0,    57,  59310,  13489,  72799
142564,21157, 0.0000000, 0.0318461, 0.0165078,     0,   187,   5456,   5872,  11328
142567,21157, 0.0000000, 0.0984332, 0.0510240,     0,   578,   5456,   5872,  11328
142567,21042, 0.0000000, 0.0619718, 0.0359242,     0,   110,   1287,   1775,   3062
142569,21042, 0.0000000, 0.1070423, 0.0620509,     0,   190,   1287,   1775,   3062
142570,21042, 0.0000000, 0.0022535, 0.0013063,     0,     4,   1287,   1775,   3062
142572,21042, 0.0000000, 0.0056338, 0.0032658,     0,    10,   1287,   1775,   3062
142573,21042, 0.0000000, 0.0242254, 0.0140431,     0,    43,   1287,   1775,   3062
142574,21147, 0.0000000, 0.0016313, 0.0005047,     0,     3,   4105,   1839,   5944
142582,21037, 0.0000000, 0.3863854, 0.1722959,     0,   403,   1296,   1043,   2339
142583,21082, 0.0136124, 0.0618102, 0.0324972,    67,   196,   4922,   3171,   8093
142584,21082, 0.0000000, 0.1261432, 0.0494254,     0,   400,   4922,   3171,   8093
143559,15105, 0.0000000, 0.0005050, 0.0005050,     0,    15,      0,  29703,  29703
143562,12031, 0.0000000, 0.0023489, 0.0017458,     0,    11,   1618,   4683,   6301
143563,12031, 0.0000000, 0.0196455, 0.0146009,     0,    92,   1618,   4683,   6301
143564,12058, 0.0000000, 0.0015553, 0.0008741,     0,    47,  23549,  30220,  53769
143565,12058, 0.0000000, 0.0013567, 0.0007625,     0,    41,  23549,  30220,  53769
143566,12058, 0.0000000, 0.0070152, 0.0039428,     0,   212,  23549,  30220,  53769
143567,12047, 0.0000000, 0.0095740, 0.0085985,     0,    60,    711,   6267,   6978
143568,12047, 0.0000000, 0.0204244, 0.0183434,     0,   128,    711,   6267,   6978
143569,12047, 0.6230661, 0.0162757, 0.0781026,   443,   102,    711,   6267,   6978
143570,12047, 0.3769339, 0.0266475, 0.0623388,   268,   167,    711,   6267,   6978
143571,12047, 0.0000000, 0.0678155, 0.0609057,     0,   425,    711,   6267,   6978
143572,12037, 0.0000000, 0.0495001, 0.0307436,     0,   203,   2502,   4101,   6603
143572,12047, 0.0000000, 0.0017552, 0.0015764,     0,    11,    711,   6267,   6978
143573,12037, 0.9996003, 0.0043892, 0.3814933,  2501,    18,   2502,   4101,   6603
143576,12055, 0.0000000, 0.0037738, 0.0012013,     0,   125,  70930,  33123, 104053
143577,12055, 0.0000000, 0.0294055, 0.0093606,     0,   974,  70930,  33123, 104053
143578,12055, 0.0000000, 0.0511729, 0.0162898,     0,  1695,  70930,  33123, 104053
143579,12055, 0.0000000, 0.0542221, 0.0172604,     0,  1796,  70930,  33123, 104053
143580,12055, 0.0002397, 0.0168765, 0.0055356,    17,   559,  70930,  33123, 104053
143583,12055, 0.0878754, 0.0008755, 0.0601809,  6233,    29,  70930,  33123, 104053
143584,12015, 0.0000000, 0.1520605, 0.0665984,     0,   845,   7131,   5557,  12688
143584,12055, 0.0000000, 0.0003321, 0.0001057,     0,    11,  70930,  33123, 104053
143585,12015, 0.0000000, 0.0129566, 0.0056747,     0,    72,   7131,   5557,  12688
143586,12015, 0.0000000, 0.0230340, 0.0100883,     0,   128,   7131,   5557,  12688
143588,17017, 0.0000000, 0.0007861, 0.0001299,     0,     8,  51408,  10177,  61585
143589,17017, 0.0000000, 0.0010809, 0.0001786,     0,    11,  51408,  10177,  61585
143591,17017, 0.0811741, 0.0040287, 0.0684258,  4173,    41,  51408,  10177,  61585
143595,17025, 0.0000000, 0.0008333, 0.0003488,     0,    11,  18334,  13200,  31534
143608,21160, 0.0000000, 0.3656578, 0.1896828,     0,   592,   1502,   1619,   3121
143608,17003, 0.0000000, 0.0495002, 0.0121977,     0,   411,  25392,   8303,  33695
143609,21160, 0.0219707, 0.0166770, 0.0192246,    33,    27,   1502,   1619,   3121
143609,17003, 0.2577583, 0.0535951, 0.2074492,  6545,   445,  25392,   8303,  33695
143610,17003, 0.0354049, 0.0362520, 0.0356136,   899,   301,  25392,   8303,  33695
143611,21051, 0.0000000, 0.0581536, 0.0227199,     0,   771,  20677,  13258,  33935
143611,17003, 0.0000000, 0.0108395, 0.0026710,     0,    90,  25392,   8303,  33695
143612,21051, 0.0314359, 0.0010560, 0.0195668,   650,    14,  20677,  13258,  33935
143613,21051, 0.1654979, 0.1301101, 0.1516723,  3422,  1725,  20677,  13258,  33935
143614,21051, 0.0223920, 0.0424649, 0.0302343,   463,   563,  20677,  13258,  33935
143615,21051, 0.0000000, 0.0896817, 0.0350376,     0,  1189,  20677,  13258,  33935
143616,21051, 0.0000000, 0.0739931, 0.0289082,     0,   981,  20677,  13258,  33935
143617,21085, 0.0000000, 0.0015568, 0.0002885,     0,    21,  59310,  13489,  72799
143618,21085, 0.0000000, 0.0034843, 0.0006456,     0,    47,  59310,  13489,  72799
143622,21085, 0.0000000, 0.0026688, 0.0004945,     0,    36,  59310,  13489,  72799
143623,21085, 0.0000000, 0.0185336, 0.0034341,     0,   250,  59310,  13489,  72799
143627,21206, 0.0000000, 0.0399619, 0.0298295,     0,   126,   1071,   3153,   4224
143628,21042, 0.0000000, 0.0326761, 0.0189419,     0,    58,   1287,   1775,   3062
143629,21042, 0.5167055, 0.0935211, 0.2713912,   665,   166,   1287,   1775,   3062
143630,21042, 0.1763792, 0.0219718, 0.0868713,   227,    39,   1287,   1775,   3062
143632,21042, 0.0000000, 0.0619718, 0.0359242,     0,   110,   1287,   1775,   3062
143635,21147, 0.0000000, 0.0059815, 0.0018506,     0,    11,   4105,   1839,   5944
143637,21169, 0.0000000, 0.0927629, 0.0704170,     0,  1442,   4933,  15545,  20478
143639,21169, 0.0000000, 0.1127694, 0.0856041,     0,  1753,   4933,  15545,  20478
143640,21082, 0.0000000, 0.0769473, 0.0301495,     0,   244,   4922,   3171,   8093
143641,21082, 0.0611540, 0.0050457, 0.0391697,   301,    16,   4922,   3171,   8093
143643,21082, 0.0000000, 0.0151372, 0.0059311,     0,    48,   4922,   3171,   8093
144618,15105, 0.0000000, 0.0067670, 0.0067670,     0,   201,      0,  29703,  29703
144619,15105, 0.0000000, 0.0088207, 0.0088207,     0,   262,      0,  29703,  29703
144620,15105, 0.0000000, 0.0056560, 0.0056560,     0,   168,      0,  29703,  29703
144623,12058, 0.0000000, 0.0043680, 0.0024549,     0,   132,  23549,  30220,  53769
144624,12058, 0.0000000, 0.0014891, 0.0008369,     0,    45,  23549,  30220,  53769
144625,12058, 0.0000000, 0.0034083, 0.0019156,     0,   103,  23549,  30220,  53769
144626,12058, 0.0000000, 0.0013567, 0.0007625,     0,    41,  23549,  30220,  53769
144626,12047, 0.0000000, 0.0052657, 0.0047291,     0,    33,    711,   6267,   6978
144627,12047, 0.0000000, 0.0078187, 0.0070221,     0,    49,    711,   6267,   6978
144628,12047, 0.0000000, 0.0148396, 0.0133276,     0,    93,    711,   6267,   6978
144629,12047, 0.0000000, 0.0540929, 0.0485813,     0,   339,    711,   6267,   6978
144630,12047, 0.0000000, 0.0223392, 0.0200631,     0,   140,    711,   6267,   6978
144631,12037, 0.0000000, 0.0212143, 0.0131758,     0,    87,   2502,   4101,   6603
144631,12047, 0.0000000, 0.0599968, 0.0538836,     0,   376,    711,   6267,   6978
144632,12037, 0.0000000, 0.0431602, 0.0268060,     0,   177,   2502,   4101,   6603
144632,12047, 0.0000000, 0.0201053, 0.0180568,     0,   126,    711,   6267,   6978
144633,12055, 0.0000000, 0.0024152, 0.0007688,     0,    80,  70930,  33123, 104053
144634,12055, 0.0000000, 0.0070042, 0.0022296,     0,   232,  70930,  33123, 104053
144635,12055, 0.0000000, 0.0148235, 0.0047187,     0,   491,  70930,  33123, 104053
144636,12055, 0.0000000, 0.0076080, 0.0024218,     0,   252,  70930,  33123, 104053
144637,12055, 0.0000000, 0.0140084, 0.0044593,     0,   464,  70930,  33123, 104053
144638,12055, 0.0653602, 0.0232165, 0.0519447,  4636,   769,  70930,  33123, 104053
144639,12055, 0.0014803, 0.0008151, 0.0012686,   105,    27,  70930,  33123, 104053
144640,12055, 0.0000000, 0.0209522, 0.0066697,     0,   694,  70930,  33123, 104053
144644,12015, 0.0000000, 0.1686162, 0.0738493,     0,   937,   7131,   5557,  12688
144645,12015, 0.0000000, 0.1986683, 0.0870114,     0,  1104,   7131,   5557,  12688
144647,17001, 0.0000000, 0.0157262, 0.0079901,     0,   136,   8373,   8648,  17021
144648,17017, 0.0000000, 0.0332121, 0.0054883,     0,   338,  51408,  10177,  61585
144649,17017, 0.0000000, 0.0021617, 0.0003572,     0,    22,  51408,  10177,  61585
144650,17017, 0.0000000, 0.0648521, 0.0107169,     0,   660,  51408,  10177,  61585
144651,17012, 0.0000000, 0.0002846, 0.0000363,     0,     2,  48088,   7027,  55115
144653,17025, 0.0000000, 0.0589394, 0.0246718,     0,   778,  18334,  13200,  31534
144655,17025, 0.0000000, 0.0407576, 0.0170610,     0,   538,  18334,  13200,  31534
144657,17025, 0.0000000, 0.0852273, 0.0356758,     0,  1125,  18334,  13200,  31534
144659,17025, 0.0000000, 0.0532576, 0.0222934,     0,   703,  18334,  13200,  31534
144662,17019, 0.0000000, 0.0188486, 0.0050896,     0,   129,  18502,   6844,  25346
144665,17019, 0.0924765, 0.0027762, 0.0682553,  1711,    19,  18502,   6844,  25346
144666,21160, 0.0000000, 0.3638048, 0.1887216,     0,   589,   1502,   1619,   3121
144666,17003, 0.0000000, 0.0009635, 0.0002374,     0,     8,  25392,   8303,  33695
144666,17019, 0.0844774, 0.0141730, 0.0654936,  1563,    97,  18502,   6844,  25346
144667,17003, 0.0000000, 0.2788149, 0.0687046,     0,  2315,  25392,   8303,  33695
144668,17003, 0.3772054, 0.0531133, 0.2973438,  9578,   441,  25392,   8303,  33695
144669,17003, 0.0191399, 0.0442009, 0.0253153,   486,   367,  25392,   8303,  33695
144670,17003, 0.0000000, 0.0963507, 0.0237424,     0,   800,  25392,   8303,  33695
144670,21051, 0.0000000, 0.0357520, 0.0139679,     0,   474,  20677,  13258,  33935
144673,21051, 0.3237897, 0.0010560, 0.1977015,  6695,    14,  20677,  13258,  33935
144674,21051, 0.3060889, 0.0026399, 0.1875350,  6329,    35,  20677,  13258,  33935
144675,21051, 0.1237123, 0.0682607, 0.1020480,  2558,   905,  20677,  13258,  33935
144677,21085, 0.0000000, 0.0830306, 0.0153848,     0,  1120,  59310,  13489,  72799
144678,21085, 0.0000000, 0.1910446, 0.0353988,     0,  2577,  59310,  13489,  72799
144682,21085, 0.0000000, 0.0090444, 0.0016758,     0,   122,  59310,  13489,  72799
144683,21085, 0.0000000, 0.0647194, 0.0119919,     0,   873,  59310,  13489,  72799
144685,21007, 0.0000000, 0.3209929, 0.2242139,     0,   763,   1026,   2377,   3403
144688,21042, 0.2571872, 0.0123944, 0.1152841,   331,    22,   1287,   1775,   3062
144691,21042, 0.0000000, 0.2523944, 0.1463096,     0,   448,   1287,   1775,   3062
144692,21042, 0.0000000, 0.0084507, 0.0048988,     0,    15,   1287,   1775,   3062
144692,21206, 0.0000000, 0.0066603, 0.0049716,     0,    21,   1071,   3153,   4224
144693,21147, 0.0000000, 0.0059815, 0.0018506,     0,    11,   4105,   1839,   5944
144693,21169, 0.0000000, 0.0211644, 0.0160660,     0,   329,   4933,  15545,  20478
144694,21169, 0.0000000, 0.0309424, 0.0234886,     0,   481,   4933,  15545,  20478
144695,21169, 0.0000000, 0.0390479, 0.0296416,     0,   607,   4933,  15545,  20478
144697,21169, 0.0000000, 0.0012223, 0.0009278,     0,    19,   4933,  15545,  20478
144699,21082, 0.0000000, 0.4654683, 0.1823798,     0,  1476,   4922,   3171,   8093
144700,21082, 0.0000000, 0.1444339, 0.0565921,     0,   458,   4922,   3171,   8093
144701,21082, 0.0000000, 0.1028067, 0.0402817,     0,   326,   4922,   3171,   8093
144703,21092, 0.0000000, 0.2534266, 0.1663795,     0,   869,   1794,   3429,   5223
144705,21092, 0.0000000, 0.0011665, 0.0007658,     0,     4,   1794,   3429,   5223
145677,15105, 0.0000000, 0.0001010, 0.0001010,     0,     3,      0,  29703,  29703
145678,15105, 0.0000000, 0.0052520, 0.0052520,     0,   156,      0,  29703,  29703
145679,15105, 0.0000000, 0.0069017, 0.0069017,     0,   205,      0,  29703,  29703
145680,15105, 0.0000000, 0.0151837, 0.0151837,     0,   451,      0,  29703,  29703
145681,15105, 0.0000000, 0.0040737, 0.0040737,     0,   121,      0,  29703,  29703
145681,12058, 0.0000000, 0.0088683, 0.0049843,     0,   268,  23549,  30220,  53769
145682,12058, 0.0000000, 0.0129054, 0.0072533,     0,   390,  23549,  30220,  53769
145683,12058, 0.0000000, 0.0024156, 0.0013577,     0,    73,  23549,  30220,  53769
145684,12058, 0.0000000, 0.0024487, 0.0013763,     0,    74,  23549,  30220,  53769
145685,12047, 0.0000000, 0.0127653, 0.0114646,     0,    80,    711,   6267,   6978
145685,12058, 0.0000000, 0.0002316, 0.0001302,     0,     7,  23549,  30220,  53769
145685,15080, 0.0000000, 0.0063473, 0.0054632,     0,   141,   3595,  22214,  25809
145686,12047, 0.0000000, 0.0065422, 0.0058756,     0,    41,    711,   6267,   6978
145687,12047, 0.0000000, 0.0264880, 0.0237891,     0,   166,    711,   6267,   6978
145688,12047, 0.0000000, 0.0157970, 0.0141874,     0,    99,    711,   6267,   6978
145689,12047, 0.0000000, 0.0039891, 0.0035827,     0,    25,    711,   6267,   6978
145690,12047, 0.0000000, 0.0330302, 0.0296647,     0,   207,    711,   6267,   6978
145691,12047, 0.0000000, 0.0309558, 0.0278017,     0,   194,    711,   6267,   6978
145692,12037, 0.0000000, 0.0334065, 0.0207481,     0,   137,   2502,   4101,   6603
145692,12047, 0.0000000, 0.0180310, 0.0161938,     0,   113,    711,   6267,   6978
145692,12055, 0.0000000, 0.0066419, 0.0021143,     0,   220,  70930,  33123, 104053
145693,12055, 0.0000000, 0.0035625, 0.0011340,     0,   118,  70930,  33123, 104053
145694,12055, 0.0000000, 0.0208013, 0.0066216,     0,   689,  70930,  33123, 104053
145695,12055, 0.0000000, 0.0076382, 0.0024315,     0,   253,  70930,  33123, 104053
145696,12055, 0.0000000, 0.0640944, 0.0204031,     0,  2123,  70930,  33123, 104053
145697,12055, 0.5318906, 0.0038342, 0.3637954, 37727,   127,  70930,  33123, 104053
145698,12055, 0.1288735, 0.0874015, 0.1156718,  9141,  2895,  70930,  33123, 104053
145699,12055, 0.0633864, 0.0444102, 0.0573458,  4496,  1471,  70930,  33123, 104053
145704,12015, 0.0000000, 0.2791074, 0.1222415,     0,  1551,   7131,   5557,  12688
145706,17001, 0.0000000, 0.0763182, 0.0387756,     0,   660,   8373,   8648,  17021
145709,17017, 0.0000000, 0.0003930, 0.0000650,     0,     4,  51408,  10177,  61585
145709,17012, 0.1192605, 0.0058346, 0.1047991,  5735,    41,  48088,   7027,  55115
145710,17012, 0.0014973, 0.1228120, 0.0169645,    72,   863,  48088,   7027,  55115
145711,17012, 0.0000000, 0.0009962, 0.0001270,     0,     7,  48088,   7027,  55115
145715,17025, 0.0000000, 0.0888636, 0.0371979,     0,  1173,  18334,  13200,  31534
145718,17025, 0.0000000, 0.0311364, 0.0130336,     0,   411,  18334,  13200,  31534
145728,17003, 0.1311437, 0.0438396, 0.1096305,  3330,   364,  25392,   8303,  33695
145729,21051, 0.0000000, 0.0377131, 0.0147341,     0,   500,  20677,  13258,  33935
145729,17003, 0.0000000, 0.0038540, 0.0009497,     0,    32,  25392,   8303,  33695
145731,21051, 0.0000000, 0.0018102, 0.0007072,     0,    24,  20677,  13258,  33935
145732,21051, 0.0000967, 0.0591341, 0.0231619,     2,   784,  20677,  13258,  33935
145734,21051, 0.0212313, 0.0642631, 0.0380433,   439,   852,  20677,  13258,  33935
145734,21021, 0.9857525, 1.0000000, 0.9869707,  1107,   105,   1123,    105,   1228
145738,21085, 0.0000000, 0.0947439, 0.0175552,     0,  1278,  59310,  13489,  72799
145746,21031, 0.0000000, 0.0402219, 0.0097841,     0,    29,   2243,    721,   2964
145748,21206, 0.0000000, 0.0815097, 0.0608428,     0,   257,   1071,   3153,   4224
145749,21206, 0.0000000, 0.0066603, 0.0049716,     0,    21,   1071,   3153,   4224
145750,21206, 0.0000000, 0.0352046, 0.0262784,     0,   111,   1071,   3153,   4224
145751,21206, 0.0000000, 0.0117349, 0.0087595,     0,    37,   1071,   3153,   4224
145752,21206, 0.0000000, 0.0602601, 0.0449811,     0,   190,   1071,   3153,   4224
145753,21169, 0.0000000, 0.0309424, 0.0234886,     0,   481,   4933,  15545,  20478
145755,21169, 0.0000000, 0.0366677, 0.0278347,     0,   570,   4933,  15545,  20478
145756,21169, 0.0000000, 0.1417819, 0.1076277,     0,  2204,   4933,  15545,  20478
145757,21169, 0.0000000, 0.0328080, 0.0249048,     0,   510,   4933,  15545,  20478
145758,21169, 0.0000000, 0.0113220, 0.0085946,     0,   176,   4933,  15545,  20478
145759,21082, 0.0000000, 0.0022075, 0.0008649,     0,     7,   4922,   3171,   8093
145764,21092, 0.0000000, 0.2563429, 0.1682941,     0,   879,   1794,   3429,   5223
145765,21092, 0.0000000, 0.1332750, 0.0874976,     0,   457,   1794,   3429,   5223
145766,21177, 0.0000000, 0.0001520, 0.0000622,     0,     3,  28526,  19742,  48268
146737,15105, 0.0000000, 0.0079117, 0.0079117,     0,   235,      0,  29703,  29703
146738,15105, 0.0000000, 0.0074067, 0.0074067,     0,   220,      0,  29703,  29703
146739,15105, 0.0000000, 0.0531933, 0.0531933,     0,  1580,      0,  29703,  29703
146741,12058, 0.0000000, 0.0029782, 0.0016738,     0,    90,  23549,  30220,  53769
146742,12058, 0.0000000, 0.0042025, 0.0023620,     0,   127,  23549,  30220,  53769
146745,12047, 0.0000000, 0.0122866, 0.0110347,     0,    77,    711,   6267,   6978
146745,15117, 0.0000000, 0.0031273, 0.0025131,     0,    38,   2970,  12151,  15121
146746,12047, 0.0000000, 0.0111696, 0.0100315,     0,    70,    711,   6267,   6978
146747,12047, 0.0000000, 0.0301580, 0.0270851,     0,   189,    711,   6267,   6978
146748,12047, 0.0000000, 0.0443593, 0.0398395,     0,   278,    711,   6267,   6978
146749,12047, 0.0000000, 0.0614329, 0.0551734,     0,   385,    711,   6267,   6978
146750,12047, 0.0000000, 0.0370193, 0.0332473,     0,   232,    711,   6267,   6978
146751,12055, 0.0000000, 0.0080911, 0.0025756,     0,   268,  70930,  33123, 104053
146752,12055, 0.0000000, 0.0089968, 0.0028639,     0,   298,  70930,  33123, 104053
146753,12055, 0.0000000, 0.0077891, 0.0024795,     0,   258,  70930,  33123, 104053
146754,12055, 0.0000000, 0.0015699, 0.0004997,     0,    52,  70930,  33123, 104053
146755,12055, 0.0000000, 0.0062796, 0.0019990,     0,   208,  70930,  33123, 104053
146756,12055, 0.0082617, 0.0153066, 0.0105043,   586,   507,  70930,  33123, 104053
146756,12060, 0.0000000, 0.0026159, 0.0022090,     0,    29,   2042,  11086,  13128
146757,12055, 0.0108276, 0.0281074, 0.0163282,   768,   931,  70930,  33123, 104053
146758,12055, 0.0008318, 0.0255110, 0.0086879,    59,   845,  70930,  33123, 104053
146759,12055, 0.0040321, 0.0009661, 0.0030561,   286,    32,  70930,  33123, 104053
146760,12055, 0.0000000, 0.0164236, 0.0052281,     0,   544,  70930,  33123, 104053
146764,17001, 0.0041801, 0.2589038, 0.1335997,    35,  2239,   8373,   8648,  17021
146765,17001, 0.0173176, 0.2561286, 0.1386523,   145,  2215,   8373,   8648,  17021
146767,17012, 0.0000000, 0.0066885, 0.0008528,     0,    47,  48088,   7027,  55115
146767,17017, 0.0000000, 0.2542006, 0.0420070,     0,  2587,  51408,  10177,  61585
146768,17012, 0.0103976, 0.0264693, 0.0124467,   500,   186,  48088,   7027,  55115
146769,17012, 0.0000000, 0.0345809, 0.0044090,     0,   243,  48088,   7027,  55115
146770,17012, 0.0000000, 0.0028462, 0.0003629,     0,    20,  48088,   7027,  55115
146771,17012, 0.1160789, 0.0243347, 0.1043817,  5582,   171,  48088,   7027,  55115
146772,17012, 0.0149310, 0.0115270, 0.0144970,   718,    81,  48088,   7027,  55115
146773,17025, 0.0000000, 0.0002273, 0.0000951,     0,     3,  18334,  13200,  31534
146774,17025, 0.0000000, 0.0206818, 0.0086573,     0,   273,  18334,  13200,  31534
146775,17025, 0.0000000, 0.0594697, 0.0248938,     0,   785,  18334,  13200,  31534
146776,17004, 0.0000000, 0.0000328, 0.0000127,     0,     1,  48393,  30473,  78866
146776,17024, 0.0000000, 0.0375052, 0.0110472,     0,   540,  34483,  14398,  48881
146778,17019, 0.0000000, 0.0198714, 0.0053657,     0,   136,  18502,   6844,  25346
146779,17019, 0.0000000, 0.0435418, 0.0117573,     0,   298,  18502,   6844,  25346
146781,17019, 0.0000000, 0.0056984, 0.0015387,     0,    39,  18502,   6844,  25346
146783,17019, 0.0039455, 0.1978375, 0.0563008,    73,  1354,  18502,   6844,  25346
146786,17003, 0.0585224, 0.0143322, 0.0476332,  1486,   119,  25392,   8303,  33695
146787,17003, 0.0000000, 0.2490666, 0.0613741,     0,  2068,  25392,   8303,  33695
146788,21051, 0.0000000, 0.0741439, 0.0289671,     0,   983,  20677,  13258,  33935
146788,17003, 0.0000000, 0.0327592, 0.0080724,     0,   272,  25392,   8303,  33695
146791,21051, 0.0000000, 0.0478956, 0.0187122,     0,   635,  20677,  13258,  33935
146792,21051, 0.0000000, 0.0029416, 0.0011493,     0,    39,  20677,  13258,  33935
146792,21176, 0.0000000, 0.0618575, 0.0415427,     0,   349,   2759,   5642,   8401
146793,21085, 0.0000000, 0.1006746, 0.0186541,     0,  1358,  59310,  13489,  72799
146793,21051, 0.0000000, 0.0219490, 0.0085752,     0,   291,  20677,  13258,  33935
146794,21176, 0.0000000, 0.2054236, 0.1379598,     0,  1159,   2759,   5642,   8401
146795,21085, 0.0459956, 0.0117132, 0.0396434,  2728,   158,  59310,  13489,  72799
146796,21085, 0.0313101, 0.0679072, 0.0380912,  1857,   916,  59310,  13489,  72799
146797,21085, 0.0615411, 0.0590852, 0.0610860,  3650,   797,  59310,  13489,  72799
146798,21085, 0.0000000, 0.0269108, 0.0049863,     0,   363,  59310,  13489,  72799
146799,21085, 0.0000000, 0.0187560, 0.0034753,     0,   253,  59310,  13489,  72799
146800,21085, 0.0000000, 0.0181629, 0.0033654,     0,   245,  59310,  13489,  72799
146802,21007, 0.0000000, 0.0244005, 0.0170438,     0,    58,   1026,   2377,   3403
146803,21007, 0.0321637, 0.0138830, 0.0193947,    33,    33,   1026,   2377,   3403
146805,21031, 0.0000000, 0.0083218, 0.0020243,     0,     6,   2243,    721,   2964
146811,21206, 0.0000000, 0.0377418, 0.0281723,     0,   119,   1071,   3153,   4224
146812,21169, 0.0000000, 0.0105500, 0.0080086,     0,   164,   4933,  15545,  20478
146812,21206, 0.0000000, 0.0272756, 0.0203598,     0,    86,   1071,   3153,   4224
146813,21169, 0.0000000, 0.0163397, 0.0124036,     0,   254,   4933,  15545,  20478
146814,21169, 0.0000000, 0.0029592, 0.0022463,     0,    46,   4933,  15545,  20478
146815,21169, 0.0000000, 0.0457382, 0.0347202,     0,   711,   4933,  15545,  20478
146816,21169, 0.0000000, 0.0681248, 0.0517140,     0,  1059,   4933,  15545,  20478
146817,21169, 0.0000000, 0.0103570, 0.0078621,     0,   161,   4933,  15545,  20478
146818,21169, 0.0000000, 0.0043101, 0.0032718,     0,    67,   4933,  15545,  20478
146818,21092, 0.0000000, 0.2499271, 0.1640819,     0,   857,   1794,   3429,   5223
146820,21092, 0.0969900, 0.0962380, 0.0964963,   174,   330,   1794,   3429,   5223
146821,21092, 0.9030100, 0.0093322, 0.3162933,  1620,    32,   1794,   3429,   5223
146822,21092, 0.0000000, 0.0002916, 0.0001915,     0,     1,   1794,   3429,   5223
147795,15105, 0.0000000, 0.0229943, 0.0229943,     0,   683,      0,  29703,  29703
147796,15105, 0.0000000, 0.0367303, 0.0367303,     0,  1091,      0,  29703,  29703
147797,15105, 0.0000000, 0.0155203, 0.0155203,     0,   461,      0,  29703,  29703
147798,15105, 0.0000000, 0.0045450, 0.0045450,     0,   135,      0,  29703,  29703
147801,15080, 0.0000000, 0.0042316, 0.0036421,     0,    94,   3595,  22214,  25809
147802,15080, 0.0000000, 0.0176915, 0.0152272,     0,   393,   3595,  22214,  25809
147803,15080, 0.0000000, 0.0028811, 0.0024798,     0,    64,   3595,  22214,  25809
147804,15080, 0.0000000, 0.0052219, 0.0044946,     0,   116,   3595,  22214,  25809
147805,12047, 0.0000000, 0.0046274, 0.0041559,     0,    29,    711,   6267,   6978
147805,15117, 0.0000000, 0.0120978, 0.0097216,     0,   147,   2970,  12151,  15121
147806,12047, 0.0000000, 0.0217010, 0.0194898,     0,   136,    711,   6267,   6978
147806,15117, 0.0000000, 0.0018106, 0.0014549,     0,    22,   2970,  12151,  15121
147807,15117, 0.0000000, 0.0103695, 0.0083328,     0,   126,   2970,  12151,  15121
147808,12047, 0.0000000, 0.0177118, 0.0159071,     0,   111,    711,   6267,   6978
147808,15117, 0.0000000, 0.0113571, 0.0091264,     0,   138,   2970,  12151,  15121
147809,12047, 0.0000000, 0.0906335, 0.0813987,     0,   568,    711,   6267,   6978
147810,12055, 0.0000000, 0.0050116, 0.0015953,     0,   166,  70930,  33123, 104053
147810,12060, 0.0000000, 0.0060437, 0.0051036,     0,    67,   2042,  11086,  13128
147811,12055, 0.0000000, 0.0026266, 0.0008361,     0,    87,  70930,  33123, 104053
147811,12060, 0.0000000, 0.0036984, 0.0031231,     0,    41,   2042,  11086,  13128
147812,12055, 0.0000000, 0.0030794, 0.0009803,     0,   102,  70930,  33123, 104053
147812,12060, 0.0000000, 0.0257983, 0.0217855,     0,   286,   2042,  11086,  13128
147813,12060, 0.0000000, 0.0014433, 0.0012188,     0,    16,   2042,  11086,  13128
147816,12060, 0.0000000, 0.0544831, 0.0460085,     0,   604,   2042,  11086,  13128
147817,12055, 0.0229663, 0.0142801, 0.0202012,  1629,   473,  70930,  33123, 104053
147818,12055, 0.0294798, 0.0556109, 0.0377980,  2091,  1842,  70930,  33123, 104053
147819,12055, 0.0000000, 0.0213447, 0.0067946,     0,   707,  70930,  33123, 104053
147820,12055, 0.0000000, 0.0408477, 0.0130030,     0,  1353,  70930,  33123, 104053
147821,12055, 0.0000000, 0.0003019, 0.0000961,     0,    10,  70930,  33123, 104053
147821,17001, 0.0000000, 0.0879972, 0.0447095,     0,   761,   8373,   8648,  17021
147822,17001, 0.0000000, 0.2613321, 0.1327772,     0,  2260,   8373,   8648,  17021
147823,17001, 0.2824555, 0.0278677, 0.1531050,  2365,   241,   8373,   8648,  17021
147824,17001, 0.6633226, 0.0130666, 0.3329417,  5554,   113,   8373,   8648,  17021
147825,17017, 0.2566332, 0.0197504, 0.2174880, 13193,   201,  51408,  10177,  61585
147825,17001, 0.0327242, 0.0017345, 0.0169790,   274,    15,   8373,   8648,  17021
147826,17017, 0.0213002, 0.0552226, 0.0269059,  1095,   562,  51408,  10177,  61585
147827,17012, 0.0387831, 0.0054077, 0.0345278,  1865,    38,  48088,   7027,  55115
147828,17012, 0.0202337, 0.0371425, 0.0223895,   973,   261,  48088,   7027,  55115
147829,17012, 0.0410082, 0.2030739, 0.0616711,  1972,  1427,  48088,   7027,  55115
147830,17012, 0.4392572, 0.1750391, 0.4055701, 21123,  1230,  48088,   7027,  55115
147831,17025, 0.0012000, 0.0403030, 0.0175683,    22,   532,  18334,  13200,  31534
147831,17012, 0.0700383, 0.0008538, 0.0612175,  3368,     6,  48088,   7027,  55115
147834,17025, 0.0000000, 0.0026515, 0.0011099,     0,    35,  18334,  13200,  31534
147835,17004, 0.0000000, 0.0271388, 0.0104861,     0,   827,  48393,  30473,  78866
147836,17004, 0.0000000, 0.0001969, 0.0000761,     0,     6,  48393,  30473,  78866
147840,17019, 0.0000000, 0.0002922, 0.0000789,     0,     2,  18502,   6844,  25346
147841,17019, 0.0000000, 0.0004383, 0.0001184,     0,     3,  18502,   6844,  25346
147842,17019, 0.6474976, 0.0203098, 0.4781425, 11980,   139,  18502,   6844,  25346
147843,17019, 0.0000000, 0.0017534, 0.0004734,     0,    12,  18502,   6844,  25346
147844,17019, 0.0000000, 0.0002922, 0.0000789,     0,     2,  18502,   6844,  25346
147844,17013, 0.0021230, 0.0012125, 0.0019173,    24,     4,  11305,   3299,  14604
147845,17019, 0.0000000, 0.0010228, 0.0002762,     0,     7,  18502,   6844,  25346
147846,17003, 0.0000000, 0.0051789, 0.0012762,     0,    43,  25392,   8303,  33695
147847,21168, 0.0000000, 0.2080745, 0.0101824,     0,    67,   6258,    322,   6580
147852,21176, 0.9035882, 0.0079759, 0.3021069,  2493,    45,   2759,   5642,   8401
147854,21176, 0.0000000, 0.1664303, 0.1117724,     0,   939,   2759,   5642,   8401
147854,21085, 0.0183949, 0.0001483, 0.0150139,  1091,     2,  59310,  13489,  72799
147858,21085, 0.0000000, 0.0393654, 0.0072941,     0,   531,  59310,  13489,  72799
147858,21062, 0.0000000, 0.1534733, 0.0827166,     0,   380,   2118,   2476,   4594
147861,21007, 0.0000000, 0.0509045, 0.0355569,     0,   121,   1026,   2377,   3403
147862,21007, 0.0019493, 0.0597392, 0.0423156,     2,   142,   1026,   2377,   3403
147863,21007, 0.4249513, 0.0748843, 0.1804290,   436,   178,   1026,   2377,   3403
147864,21007, 0.0000000, 0.0016828, 0.0011754,     0,     4,   1026,   2377,   3403
147865,21031, 0.0000000, 0.4355063, 0.1059379,     0,   314,   2243,    721,   2964
147867,21031, 0.0000000, 0.1525659, 0.0371120,     0,   110,   2243,    721,   2964
147868,21031, 0.0000000, 0.1081831, 0.0263158,     0,    78,   2243,    721,   2964
147869,21206, 0.3893557, 0.0063432, 0.1034564,   417,    20,   1071,   3153,   4224
147871,21206, 0.0000000, 0.0015858, 0.0011837,     0,     5,   1071,   3153,   4224
147872,21169, 0.0000000, 0.0002573, 0.0001953,     0,     4,   4933,  15545,  20478
147874,21169, 0.9057369, 0.0054680, 0.2223362,  4468,    85,   4933,  15545,  20478
147875,21169, 0.0942631, 0.0183982, 0.0366735,   465,   286,   4933,  15545,  20478
147877,21169, 0.0000000, 0.0677388, 0.0514210,     0,  1053,   4933,  15545,  20478
148854,15105, 0.0000000, 0.0255193, 0.0255193,     0,   758,      0,  29703,  29703
148855,15105, 0.0000000, 0.0036360, 0.0036360,     0,   108,      0,  29703,  29703
148856,15105, 0.0000000, 0.0131637, 0.0131637,     0,   391,      0,  29703,  29703
148857,15008, 0.0000000, 0.0123216, 0.0098352,     0,   259,   5314,  21020,  26334
148860,15080, 0.0000000, 0.0160709, 0.0138324,     0,   357,   3595,  22214,  25809
148861,15080, 0.0000000, 0.0536599, 0.0461854,     0,  1192,   3595,  22214,  25809
148862,15080, 0.0000000, 0.0072477, 0.0062381,     0,   161,   3595,  22214,  25809
148863,15117, 0.0000000, 0.0095465, 0.0076715,     0,   116,   2970,  12151,  15121
148863,15080, 0.0000000, 0.0095885, 0.0082529,     0,   213,   3595,  22214,  25809
148865,15117, 0.0000000, 0.0349765, 0.0281066,     0,   425,   2970,  12151,  15121
148866,15117, 0.0000000, 0.0278989, 0.0224192,     0,   339,   2970,  12151,  15121
148867,15117, 0.0000000, 0.0174471, 0.0140202,     0,   212,   2970,  12151,  15121
148868,12047, 0.0000000, 0.0062231, 0.0055890,     0,    39,    711,   6267,   6978
148868,15117, 0.0000000, 0.0217266, 0.0174592,     0,   264,   2970,  12151,  15121
148869,12060, 0.0000000, 0.0284142, 0.0239945,     0,   315,   2042,  11086,  13128
148870,12060, 0.0000000, 0.0200253, 0.0169104,     0,   222,   2042,  11086,  13128
148871,12060, 0.0000000, 0.0082086, 0.0069317,     0,    91,   2042,  11086,  13128
148872,12060, 0.0000000, 0.0041494, 0.0035040,     0,    46,   2042,  11086,  13128
148873,12060, 1.0000000, 0.0465452, 0.1948507,  2042,   516,   2042,  11086,  13128
148874,12060, 0.0000000, 0.1119430, 0.0945308,     0,  1241,   2042,  11086,  13128
148875,12060, 0.0000000, 0.1175356, 0.0992535,     0,  1303,   2042,  11086,  13128
148876,12060, 0.0000000, 0.0380660, 0.0321450,     0,   422,   2042,  11086,  13128
148878,12055, 0.0000000, 0.0028681, 0.0009130,     0,    95,  70930,  33123, 104053
148879,12055, 0.0000000, 0.0214654, 0.0068331,     0,   711,  70930,  33123, 104053
148883,17001, 0.0000000, 0.0009251, 0.0004700,     0,     8,   8373,   8648,  17021
148883,17014, 0.0000000, 0.0077805, 0.0040186,     0,    38,   4572,   4884,   9456
148883,17017, 0.0000000, 0.0314435, 0.0051961,     0,   320,  51408,  10177,  61585
148884,17017, 0.1241636, 0.1223347, 0.1238613,  6383,  1245,  51408,  10177,  61585
148885,17017, 0.0083061, 0.0332121, 0.0124219,   427,   338,  51408,  10177,  61585
148886,17017, 0.0053883, 0.0065835, 0.0055858,   277,    67,  51408,  10177,  61585
148888,17012, 0.0356846, 0.2484702, 0.0628141,  1716,  1746,  48088,   7027,  55115
148888,17031, 0.3302798, 0.2388223, 0.3231041, 10672,   657,  32312,   2751,  35063
148889,17012, 0.0733447, 0.0488117, 0.0702168,  3527,   343,  48088,   7027,  55115
148889,17025, 0.0134722, 0.0549242, 0.0308239,   247,   725,  18334,  13200,  31534
148890,17025, 0.9331843, 0.0862121, 0.5786453, 17109,  1138,  18334,  13200,  31534
148891,17025, 0.0000000, 0.0217424, 0.0091013,     0,   287,  18334,  13200,  31534
148895,17004, 0.0062199, 0.0014111, 0.0043618,   301,    43,  48393,  30473,  78866
148895,17024, 0.0000000, 0.0855674, 0.0252041,     0,  1232,  34483,  14398,  48881
148896,17004, 0.0533342, 0.0007876, 0.0330307,  2581,    24,  48393,  30473,  78866
148897,17004, 0.0000000, 0.0004922, 0.0001902,     0,    15,  48393,  30473,  78866
148897,17019, 0.0000000, 0.2504383, 0.0676241,     0,  1714,  18502,   6844,  25346
148898,17019, 0.0000000, 0.2828755, 0.0763829,     0,  1936,  18502,   6844,  25346
148899,17019, 0.0000000, 0.0492402, 0.0132960,     0,   337,  18502,   6844,  25346
148900,17019, 0.0000000, 0.0020456, 0.0005524,     0,    14,  18502,   6844,  25346
148902,17019, 0.0000000, 0.0001461, 0.0000395,     0,     1,  18502,   6844,  25346
148903,17013, 0.1130473, 0.0072749, 0.0891537,  1278,    24,  11305,   3299,  14604
148904,17013, 0.1184432, 0.0033343, 0.0924404,  1339,    11,  11305,   3299,  14604
148904,17010, 0.0000000, 0.3248162, 0.1186246,     0,  1856,   9932,   5714,  15646
148905,17010, 0.0000000, 0.0428771, 0.0156590,     0,   245,   9932,   5714,  15646
148908,21168, 0.2572707, 0.4782609, 0.2680851,  1610,   154,   6258,    322,   6580
148911,21176, 0.0634288, 0.4025168, 0.2911558,   175,  2271,   2759,   5642,   8401
148912,21176, 0.0025372, 0.0023041, 0.0023807,     7,    13,   2759,   5642,   8401
148913,21176, 0.0000000, 0.1533144, 0.1029639,     0,   865,   2759,   5642,   8401
148914,21085, 0.2031866, 0.0010379, 0.1657303, 12051,    14,  59310,  13489,  72799
148915,21085, 0.0625527, 0.0022982, 0.0513881,  3710,    31,  59310,  13489,  72799
148916,21085, 0.0000000, 0.0547854, 0.0101512,     0,   739,  59310,  13489,  72799
148916,21062, 0.0000000, 0.0601777, 0.0324336,     0,   149,   2118,   2476,   4594
148917,21062, 0.0000000, 0.6280291, 0.3384850,     0,  1555,   2118,   2476,   4594
148918,21062, 0.0000000, 0.1546850, 0.0833696,     0,   383,   2118,   2476,   4594
148920,21007, 0.0000000, 0.0201935, 0.0141052,     0,    48,   1026,   2377,   3403
148924,21031, 0.3771734, 0.0984743, 0.3093792,   846,    71,   2243,    721,   2964
148925,21031, 0.6219349, 0.1567268, 0.5087720,  1395,   113,   2243,    721,   2964
148929,21206, 0.0233427, 0.0437678, 0.0385890,    25,   138,   1071,   3153,   4224
148931,21206, 0.0000000, 0.0069775, 0.0052083,     0,    22,   1071,   3153,   4224
148933,21169, 0.0000000, 0.0039884, 0.0030276,     0,    62,   4933,  15545,  20478
148934,21169, 0.0000000, 0.0441943, 0.0335482,     0,   687,   4933,  15545,  20478
148935,21169, 0.0000000, 0.0157607, 0.0119641,     0,   245,   4933,  15545,  20478
148943,21177, 0.2058824, 0.0042042, 0.1233944,  5873,    83,  28526,  19742,  48268
149913,15008, 0.3571697, 0.0348716, 0.0999089,  1898,   733,   5314,  21020,  26334
149914,15008, 0.0000000, 0.0049477, 0.0039493,     0,   104,   5314,  21020,  26334
149915,15008, 0.0000000, 0.0040438, 0.0032278,     0,    85,   5314,  21020,  26334
149916,15008, 0.0000000, 0.0238820, 0.0190628,     0,   502,   5314,  21020,  26334
149920,15080, 0.0000000, 0.0488431, 0.0420396,     0,  1085,   3595,  22214,  25809
149921,15080, 0.0000000, 0.0193572, 0.0166609,     0,   430,   3595,  22214,  25809
149922,15080, 0.0000000, 0.0019357, 0.0016661,     0,    43,   3595,  22214,  25809
149923,15080, 0.0000000, 0.0054920, 0.0047270,     0,   122,   3595,  22214,  25809
149924,15117, 0.0000000, 0.0433709, 0.0348522,     0,   527,   2970,  12151,  15121
149925,15117, 0.0000000, 0.0563740, 0.0453012,     0,   685,   2970,  12151,  15121
149926,15117, 0.0000000, 0.0112748, 0.0090602,     0,   137,   2970,  12151,  15121
149927,15117, 0.0000000, 0.0014814, 0.0011904,     0,    18,   2970,  12151,  15121
149929,12060, 0.0000000, 0.0237236, 0.0200335,     0,   263,   2042,  11086,  13128
149930,12060, 0.0000000, 0.0456432, 0.0385436,     0,   506,   2042,  11086,  13128
149931,12060, 0.0000000, 0.0495219, 0.0418190,     0,   549,   2042,  11086,  13128
149932,12060, 0.0000000, 0.0604366, 0.0510360,     0,   670,   2042,  11086,  13128
149933,12049, 0.0000000, 0.0507316, 0.0275999,     0,   319,   5270,   6288,  11558
149934,12060, 0.0000000, 0.1076132, 0.0908745,     0,  1193,   2042,  11086,  13128
149934,12049, 0.0000000, 0.0017494, 0.0009517,     0,    11,   5270,   6288,  11558
149937,12049, 0.0000000, 0.0850827, 0.0462883,     0,   535,   5270,   6288,  11558
149939,17021, 0.0000000, 0.1240188, 0.0424674,     0,   316,   4893,   2548,   7441
149939,17005, 0.0000000, 0.0428591, 0.0336818,     0,   319,   2028,   7443,   9471
149940,17021, 0.0000000, 0.0035322, 0.0012095,     0,     9,   4893,   2548,   7441
149941,17014, 0.0000000, 0.4879197, 0.2520093,     0,  2383,   4572,   4884,   9456
149942,17014, 0.0000000, 0.0012285, 0.0006345,     0,     6,   4572,   4884,   9456
149945,17017, 0.0811158, 0.0156235, 0.0702931,  4170,   159,  51408,  10177,  61585
149946,17017, 0.0276027, 0.0671121, 0.0341317,  1419,   683,  51408,  10177,  61585
149947,17031, 0.1159012, 0.5539804, 0.1502724,  3745,  1524,  32312,   2751,  35063
149947,17017, 0.0000000, 0.0021617, 0.0003572,     0,    22,  51408,  10177,  61585
149948,17012, 0.0000000, 0.0448271, 0.0057153,     0,   315,  48088,   7027,  55115
149948,17031, 0.5538190, 0.0316249, 0.5128483, 17895,    87,  32312,   2751,  35063
149948,17024, 0.0552736, 0.0088901, 0.0416113,  1906,   128,  34483,  14398,  48881
149949,17025, 0.0521436, 0.1650000, 0.0993848,   956,  2178,  18334,  13200,  31534
149949,17024, 0.0047270, 0.0341714, 0.0133999,   163,   492,  34483,  14398,  48881
149950,17024, 0.0000000, 0.0004862, 0.0001432,     0,     7,  34483,  14398,  48881
149953,17024, 0.0000000, 0.0019447, 0.0005728,     0,    28,  34483,  14398,  48881
149954,17024, 0.0000000, 0.0018753, 0.0005524,     0,    27,  34483,  14398,  48881
149954,17004, 0.0000000, 0.0002297, 0.0000888,     0,     7,  48393,  30473,  78866
149955,17004, 0.0000000, 0.0127982, 0.0049451,     0,   390,  48393,  30473,  78866
149956,17019, 0.0000000, 0.0054062, 0.0014598,     0,    37,  18502,   6844,  25346
149956,17004, 0.0000000, 0.0129623, 0.0050085,     0,   395,  48393,  30473,  78866
149957,17004, 0.0000000, 0.0023299, 0.0009003,     0,    71,  48393,  30473,  78866
149957,17019, 0.0000000, 0.0680888, 0.0183855,     0,   466,  18502,   6844,  25346
149960,17019, 0.1289050, 0.0048217, 0.0953997,  2385,    33,  18502,   6844,  25346
149961,17019, 0.0426981, 0.0073057, 0.0331413,   790,    50,  18502,   6844,  25346
149961,17013, 0.0000000, 0.0812367, 0.0183511,     0,   268,  11305,   3299,  14604
149962,17013, 0.0000000, 0.0057593, 0.0013010,     0,    19,  11305,   3299,  14604
149963,17010, 0.0000000, 0.0024501, 0.0008948,     0,    14,   9932,   5714,  15646
149963,17013, 0.0000000, 0.0012125, 0.0002739,     0,     4,  11305,   3299,  14604
149965,21168, 0.1673058, 0.0093168, 0.1595745,  1047,     3,   6258,    322,   6580
149968,21168, 0.0955577, 0.0310559, 0.0924012,   598,    10,   6258,    322,   6580
149970,21176, 0.0000000, 0.0001772, 0.0001190,     0,     1,   2759,   5642,   8401
149973,21085, 0.0060867, 0.0020758, 0.0053435,   361,    28,  59310,  13489,  72799
149974,21085, 0.0000000, 0.0005189, 0.0000962,     0,     7,  59310,  13489,  72799
149976,21062, 0.1704438, 0.0020194, 0.0796691,   361,     5,   2118,   2476,   4594
149977,21062, 0.8295562, 0.0016155, 0.3833261,  1757,     4,   2118,   2476,   4594
149977,21133, 0.6870109, 1.0000000, 0.6927803,   439,    12,    639,     12,    651
149978,21201, 0.9884477, 0.2042175, 0.5450267,  1369,   368,   1385,   1802,   3187
149981,21007, 0.0000000, 0.4333193, 0.3026741,     0,  1030,   1026,   2377,   3403
149990,21206, 0.0000000, 0.0643831, 0.0480587,     0,   203,   1071,   3153,   4224
149991,21206, 0.0000000, 0.2825880, 0.2109375,     0,   891,   1071,   3153,   4224
149998,21203, 0.0000000, 0.0367647, 0.0057861,     0,    35,   5097,    952,   6049
150000,21177, 0.0000000, 0.0573903, 0.0234731,     0,  1133,  28526,  19742,  48268
150002,21177, 0.0006661, 0.0307466, 0.0129693,    19,   607,  28526,  19742,  48268
150972,15008, 0.0543846, 0.0449572, 0.0468596,   289,   945,   5314,  21020,  26334
150973,15008, 0.0000000, 0.0047574, 0.0037974,     0,   100,   5314,  21020,  26334
150974,15008, 0.0000000, 0.0102284, 0.0081643,     0,   215,   5314,  21020,  26334
150975,15080, 0.0000000, 0.0087782, 0.0075555,     0,   195,   3595,  22214,  25809
150976,15080, 0.0000000, 0.0163861, 0.0141036,     0,   364,   3595,  22214,  25809
150977,15080, 0.0000000, 0.0072477, 0.0062381,     0,   161,   3595,  22214,  25809
150980,15080, 0.0000000, 0.0137751, 0.0118563,     0,   306,   3595,  22214,  25809
150981,15080, 0.0000000, 0.0018457, 0.0015886,     0,    41,   3595,  22214,  25809
150982,15117, 0.0000000, 0.0275697, 0.0221546,     0,   335,   2970,  12151,  15121
150983,15117, 0.0000000, 0.0144844, 0.0116394,     0,   176,   2970,  12151,  15121
150985,15117, 0.0000000, 0.0046087, 0.0037035,     0,    56,   2970,  12151,  15121
150986,15117, 0.0000000, 0.0198338, 0.0159381,     0,   241,   2970,  12151,  15121
150987,12060, 0.0000000, 0.1082446, 0.0914077,     0,  1200,   2042,  11086,  13128
150987,15117, 0.0000000, 0.0741503, 0.0595860,     0,   901,   2970,  12151,  15121
150988,12060, 0.0000000, 0.0403211, 0.0340494,     0,   447,   2042,  11086,  13128
150989,12060, 0.0000000, 0.0382464, 0.0322974,     0,   424,   2042,  11086,  13128
150989,12049, 0.0000000, 0.0222646, 0.0121128,     0,   140,   5270,   6288,  11558
150990,12049, 0.0000000, 0.0430980, 0.0234470,     0,   271,   5270,   6288,  11558
150992,12049, 0.0000000, 0.0403944, 0.0219761,     0,   254,   5270,   6288,  11558
150994,12049, 0.0000000, 0.0979644, 0.0532964,     0,   616,   5270,   6288,  11558
150996,12049, 0.0000000, 0.2054707, 0.1117840,     0,  1292,   5270,   6288,  11558
150997,17005, 0.0000000, 0.2046218, 0.1608067,     0,  1523,   2028,   7443,   9471
150997,17021, 0.0000000, 0.0019623, 0.0006720,     0,     5,   4893,   2548,   7441
150998,17021, 0.0000000, 0.0070644, 0.0024190,     0,    18,   4893,   2548,   7441
151000,17021, 0.0000000, 0.1354003, 0.0463647,     0,   345,   4893,   2548,   7441
151001,17021, 0.0000000, 0.1581633, 0.0541594,     0,   403,   4893,   2548,   7441
151001,17014, 0.0000000, 0.0002048, 0.0001058,     0,     1,   4572,   4884,   9456
151002,17017, 0.0000000, 0.0001965, 0.0000325,     0,     2,  51408,  10177,  61585
151003,17017, 0.0000000, 0.1406112, 0.0232362,     0,  1431,  51408,  10177,  61585
151004,17017, 0.0087730, 0.0019652, 0.0076480,   451,    20,  51408,  10177,  61585
151005,17017, 0.3709150, 0.0752678, 0.3220589, 19068,   766,  51408,  10177,  61585
151007,17024, 0.2726271, 0.0253507, 0.1997913,  9401,   365,  34483,  14398,  48881
151007,17031, 0.0000000, 0.1755725, 0.0137752,     0,   483,  32312,   2751,  35063
151008,17024, 0.0415857, 0.0043062, 0.0306049,  1434,    62,  34483,  14398,  48881
151009,17024, 0.3446046, 0.0281289, 0.2513860, 11883,   405,  34483,  14398,  48881
151010,17024, 0.0061190, 0.0668843, 0.0240175,   211,   963,  34483,  14398,  48881
151013,17004, 0.0000000, 0.0013126, 0.0005072,     0,    40,  48393,  30473,  78866
151014,17004, 0.0000000, 0.0624159, 0.0241169,     0,  1902,  48393,  30473,  78866
151015,17004, 0.0000000, 0.0362288, 0.0139984,     0,  1104,  48393,  30473,  78866
151017,17019, 0.0000000, 0.0027762, 0.0007496,     0,    19,  18502,   6844,  25346
151017,17004, 0.0000000, 0.0081712, 0.0031573,     0,   249,  48393,  30473,  78866
151018,17004, 0.0000000, 0.0001641, 0.0000634,     0,     5,  48393,  30473,  78866
151020,17013, 0.3231314, 0.0166717, 0.2539030,  3653,    55,  11305,   3299,  14604
151021,17010, 0.0000000, 0.4343717, 0.1586348,     0,  2482,   9932,   5714,  15646
151021,17013, 0.2824414, 0.0187936, 0.2228841,  3193,    62,  11305,   3299,  14604
151022,17010, 0.0000000, 0.0014001, 0.0005113,     0,     8,   9932,   5714,  15646
151023,17010, 0.0000000, 0.0015751, 0.0005752,     0,     9,   9932,   5714,  15646
151025,21069, 0.0000000, 0.0084349, 0.0056753,     0,   144,   8301,  17072,  25373
151026,21168, 0.0000000, 0.2732919, 0.0133739,     0,    88,   6258,    322,   6580
151026,21069, 0.0000000, 0.0139410, 0.0093801,     0,   238,   8301,  17072,  25373
151029,21185, 0.0000000, 0.2464330, 0.1664684,     0,  1399,   2727,   5677,   8404
151030,21185, 0.0000000, 0.2508367, 0.1694431,     0,  1424,   2727,   5677,   8404
151031,21185, 0.0000000, 0.0024661, 0.0016659,     0,    14,   2727,   5677,   8404
151033,21085, 0.0509189, 0.0133442, 0.0439566,  3020,   180,  59310,  13489,  72799
151033,21166, 0.0000000, 0.0853733, 0.0346326,     0,   279,   4788,   3268,   8056
151036,21201, 0.0000000, 0.7957824, 0.4499529,     0,  1434,   1385,   1802,   3187
151043,21070, 0.0000000, 0.0996718, 0.0868583,     0,   577,    854,   5789,   6643
151043,21159, 0.0000000, 0.2092366, 0.0551690,     0,   222,   2963,   1061,   4024
151045,21070, 0.0000000, 0.0440491, 0.0383863,     0,   255,    854,   5789,   6643
151046,21070, 0.0000000, 0.0687511, 0.0599127,     0,   398,    854,   5789,   6643
151048,21052, 0.0000000, 1.0000000, 0.0016300,     0,     2,   1225,      2,   1227
151049,21070, 0.0000000, 0.0234928, 0.0204727,     0,   136,    854,   5789,   6643
151050,21206, 0.0000000, 0.0856327, 0.0639205,     0,   270,   1071,   3153,   4224
151051,21206, 0.0000000, 0.2017127, 0.1505682,     0,   636,   1071,   3153,   4224
151054,21098, 0.0000000, 0.2685814, 0.1970087,     0,  1225,   1657,   4561,   6218
151057,21203, 0.0000000, 0.1397059, 0.0219871,     0,   133,   5097,    952,   6049
151059,21177, 0.0000351, 0.0802857, 0.0328582,     1,  1585,  28526,  19742,  48268
152031,15008, 0.0000000, 0.0205994, 0.0164426,     0,   433,   5314,  21020,  26334
152032,15008, 0.0000000, 0.0097050, 0.0077466,     0,   204,   5314,  21020,  26334
152033,15008, 0.0000000, 0.0050428, 0.0040252,     0,   106,   5314,  21020,  26334
152035,15080, 0.0000000, 0.0016206, 0.0013949,     0,    36,   3595,  22214,  25809
152038,15080, 0.0000000, 0.0026560, 0.0022860,     0,    59,   3595,  22214,  25809
152039,15080, 0.0000000, 0.0054470, 0.0046883,     0,   121,   3595,  22214,  25809
152040,15080, 0.0000000, 0.0268749, 0.0231315,     0,   597,   3595,  22214,  25809
152041,15080, 0.0000000, 0.0450167, 0.0387462,     0,  1000,   3595,  22214,  25809
152044,15117, 0.0000000, 0.0411489, 0.0330666,     0,   500,   2970,  12151,  15121
152045,15117, 1.0000000, 0.0576084, 0.2427088,  2970,   700,   2970,  12151,  15121
152046,12060, 0.0000000, 0.0223706, 0.0188909,     0,   248,   2042,  11086,  13128
152046,15117, 0.0000000, 0.0330014, 0.0265194,     0,   401,   2970,  12151,  15121
152047,12060, 0.0000000, 0.0349089, 0.0294790,     0,   387,   2042,  11086,  13128
152047,12049, 0.0000000, 0.0050891, 0.0027686,     0,    32,   5270,   6288,  11558
152048,12049, 0.0000000, 0.1401081, 0.0762243,     0,   881,   5270,   6288,  11558
152049,12049, 0.0083491, 0.0030216, 0.0054508,    44,    19,   5270,   6288,  11558
152050,12049, 0.0000000, 0.0114504, 0.0062295,     0,    72,   5270,   6288,  11558
152051,12049, 0.0000000, 0.0709288, 0.0385880,     0,   446,   5270,   6288,  11558
152055,12049, 0.0000000, 0.0014313, 0.0007787,     0,     9,   5270,   6288,  11558
152055,17005, 0.0000000, 0.0080613, 0.0063351,     0,    60,   2028,   7443,   9471
152055,15119, 0.0000000, 0.0042246, 0.0031775,     0,    52,   4056,  12309,  16365
152056,17005, 0.0000000, 0.1530297, 0.1202619,     0,  1139,   2028,   7443,   9471
152058,17021, 0.4586143, 0.1189168, 0.3422927,  2244,   303,   4893,   2548,   7441
152059,17021, 0.2556714, 0.0286499, 0.1779331,  1251,    73,   4893,   2548,   7441
152059,17014, 0.0085302, 0.1449631, 0.0789975,    39,   708,   4572,   4884,   9456
152060,17014, 0.7307524, 0.0556921, 0.3820854,  3341,   272,   4572,   4884,   9456
152061,17015, 0.4067828, 0.0090972, 0.2685874,  6633,    79,  16306,   8684,  24990
152062,17015, 0.0000000, 0.0013819, 0.0004802,     0,    12,  16306,   8684,  24990
152063,17017, 0.0000000, 0.0030461, 0.0005034,     0,    31,  51408,  10177,  61585
152063,17028, 0.0000000, 0.0637935, 0.0141523,     0,   897,  49321,  14061,  63382
152064,17017, 0.0026455, 0.0419574, 0.0091418,   136,   427,  51408,  10177,  61585
152066,17024, 0.1561349, 0.0229199, 0.1168961,  5384,   330,  34483,  14398,  48881
152067,17024, 0.0000000, 0.2126684, 0.0626419,     0,  3062,  34483,  14398,  48881
152068,17024, 0.0044660, 0.1531463, 0.0482601,   154,  2205,  34483,  14398,  48881
152069,17024, 0.0014500, 0.1105709, 0.0335918,    50,  1592,  34483,  14398,  48881
152073,17004, 0.0446552, 0.0015095, 0.0279842,  2161,    46,  48393,  30473,  78866
152074,17004, 0.0003720, 0.0281889, 0.0111201,    18,   859,  48393,  30473,  78866
152075,17004, 0.0000000, 0.0771503, 0.0298101,     0,  2351,  48393,  30473,  78866
152076,17004, 0.0418862, 0.0895875, 0.0603175,  2027,  2730,  48393,  30473,  78866
152077,17004, 0.0000000, 0.0033144, 0.0012807,     0,   101,  48393,  30473,  78866
152078,17013, 0.0000000, 0.1515611, 0.0342372,     0,   500,  11305,   3299,  14604
152079,17013, 0.0490933, 0.7108214, 0.1985757,   555,  2345,  11305,   3299,  14604
152079,17010, 0.0037253, 0.0094505, 0.0058162,    37,    54,   9932,   5714,  15646
152080,17013, 0.0638655, 0.0021219, 0.0499178,   722,     7,  11305,   3299,  14604
152080,17010, 0.3738421, 0.0957298, 0.2722740,  3713,   547,   9932,   5714,  15646
152086,21069, 0.0000000, 0.0231959, 0.0156071,     0,   396,   8301,  17072,  25373
152087,21069, 0.0000000, 0.0195056, 0.0131242,     0,   333,   8301,  17072,  25373
152088,21185, 0.0003667, 0.1097411, 0.0742504,     1,   623,   2727,   5677,   8404
152088,21069, 0.0000000, 0.0174555, 0.0117448,     0,   298,   8301,  17072,  25373
152089,21185, 0.9996333, 0.1063942, 0.3962399,  2726,   604,   2727,   5677,   8404
152090,21185, 0.0000000, 0.1462040, 0.0987625,     0,   830,   2727,   5677,   8404
152092,21166, 0.0000000, 0.1242350, 0.0503972,     0,   406,   4788,   3268,   8056
152102,21150, 0.0000000, 0.0977526, 0.0634561,     0,   448,   2477,   4583,   7060
152105,21070, 0.0175644, 0.2509933, 0.2209845,    15,  1453,    854,   5789,   6643
152106,21070, 0.9777517, 0.0006910, 0.1262984,   835,     4,    854,   5789,   6643
152107,21070, 0.0000000, 0.1088271, 0.0948367,     0,   630,    854,   5789,   6643
152108,21070, 0.0000000, 0.0044913, 0.0039139,     0,    26,    854,   5789,   6643
152109,21070, 0.0000000, 0.0096735, 0.0084299,     0,    56,    854,   5789,   6643
152112,21098, 0.0000000, 0.1578601, 0.1157929,     0,   720,   1657,   4561,   6218
152113,21098, 0.0000000, 0.1872396, 0.1373432,     0,   854,   1657,   4561,   6218
152116,21203, 0.0164803, 0.1281513, 0.0340552,    84,   122,   5097,    952,   6049
152117,21203, 0.0000000, 0.0472689, 0.0074392,     0,    45,   5097,    952,   6049
152117,21177, 0.0000000, 0.0759801, 0.0310765,     0,  1500,  28526,  19742,  48268
152118,21177, 0.0000000, 0.0460946, 0.0188531,     0,   910,  28526,  19742,  48268
152119,21177, 0.1043960, 0.0004559, 0.0618837,  2978,     9,  28526,  19742,  48268
153090,15008, 0.0000000, 0.0566603, 0.0452267,     0,  1191,   5314,  21020,  26334
153091,15008, 0.0000000, 0.0356327, 0.0284423,     0,   749,   5314,  21020,  26334
153092,15008, 0.0000000, 0.0013321, 0.0010633,     0,    28,   5314,  21020,  26334
153092,15080, 0.0000000, 0.0027460, 0.0023635,     0,    61,   3595,  22214,  25809
153093,15080, 0.0000000, 0.0191771, 0.0165059,     0,   426,   3595,  22214,  25809
153095,15080, 0.0000000, 0.0304763, 0.0262312,     0,   677,   3595,  22214,  25809
153096,15080, 0.0000000, 0.0180967, 0.0155760,     0,   402,   3595,  22214,  25809
153097,15080, 0.0000000, 0.0045017, 0.0038746,     0,   100,   3595,  22214,  25809
153098,15080, 0.0000000, 0.0108940, 0.0093766,     0,   242,   3595,  22214,  25809
153099,15080, 0.0000000, 0.0234087, 0.0201480,     0,   520,   3595,  22214,  25809
153100,15080, 0.0000000, 0.0463221, 0.0398698,     0,  1029,   3595,  22214,  25809
153101,15080, 0.0000000, 0.0062573, 0.0053857,     0,   139,   3595,  22214,  25809
153102,15004, 0.0000000, 0.0506708, 0.0399165,     0,   593,   3153,  11703,  14856
153103,15117, 0.0000000, 0.0493787, 0.0396799,     0,   600,   2970,  12151,  15121
153104,15117, 0.0000000, 0.0343182, 0.0275775,     0,   417,   2970,  12151,  15121
153105,15117, 0.0000000, 0.0427948, 0.0343893,     0,   520,   2970,  12151,  15121
153106,15117, 0.0000000, 0.0415604, 0.0333973,     0,   505,   2970,  12151,  15121
153107,15117, 0.0000000, 0.0268291, 0.0215594,     0,   326,   2970,  12151,  15121
153108,12049, 0.9916509, 0.0419847, 0.4749957,  5226,   264,   5270,   6288,  11558
153109,15107, 0.0000000, 0.0288928, 0.0108273,     0,   131,   7565,   4534,  12099
153110,15107, 0.0000000, 0.0050728, 0.0019010,     0,    23,   7565,   4534,  12099
153114,15119, 0.0000000, 0.0142172, 0.0106936,     0,   175,   4056,  12309,  16365
153115,17005, 0.0000000, 0.0528013, 0.0414951,     0,   393,   2028,   7443,   9471
153115,15119, 0.0000000, 0.0510196, 0.0383746,     0,   628,   4056,  12309,  16365
153116,17005, 0.9980276, 0.4453849, 0.5637208,  2024,  3315,   2028,   7443,   9471
153117,17021, 0.0743920, 0.4069859, 0.1882811,   364,  1037,   4893,   2548,   7441
153117,17005, 0.0019724, 0.0193470, 0.0156267,     4,   144,   2028,   7443,   9471
153118,17014, 0.0223097, 0.0595823, 0.0415609,   102,   291,   4572,   4884,   9456
153118,17021, 0.2113223, 0.0153061, 0.1442010,  1034,    39,   4893,   2548,   7441
153119,17014, 0.2384077, 0.2426290, 0.2405880,  1090,  1185,   4572,   4884,   9456
153119,17015, 0.0294983, 0.1172271, 0.0599840,   481,  1018,  16306,   8684,  24990
153120,17015, 0.1471851, 0.0870567, 0.1262905,  2400,   756,  16306,   8684,  24990
153122,17028, 0.1136433, 0.0339236, 0.0959578,  5605,   477,  49321,  14061,  63382
153123,17028, 0.0914621, 0.0767371, 0.0881954,  4511,  1079,  49321,  14061,  63382
153124,17028, 0.0475457, 0.0403243, 0.0459436,  2345,   567,  49321,  14061,  63382
153125,17024, 0.0000000, 0.0022920, 0.0006751,     0,    33,  34483,  14398,  48881
153125,17028, 0.0000000, 0.0292298, 0.0064845,     0,   411,  49321,  14061,  63382
153125,17008, 0.0000000, 0.0014265, 0.0000719,     0,     6,  79279,   4206,  83485
153126,17024, 0.0000000, 0.1083484, 0.0319142,     0,  1560,  34483,  14398,  48881
153127,17024, 0.0064960, 0.0002084, 0.0046439,   224,     3,  34483,  14398,  48881
153128,17024, 0.0000000, 0.0060425, 0.0017798,     0,    87,  34483,  14398,  48881
153131,17004, 0.0128118, 0.0016080, 0.0084827,   620,    49,  48393,  30473,  78866
153132,17004, 0.0144856, 0.1485577, 0.0662897,   701,  4527,  48393,  30473,  78866
153133,17004, 0.1666563, 0.1007449, 0.1411889,  8065,  3070,  48393,  30473,  78866
153135,17004, 0.0318021, 0.0007876, 0.0198184,  1539,    24,  48393,  30473,  78866
153137,17010, 0.0000000, 0.0033252, 0.0012144,     0,    19,   9932,   5714,  15646
153137,17004, 0.0000000, 0.0423326, 0.0163569,     0,  1290,  48393,  30473,  78866
153138,17010, 0.2211035, 0.0479524, 0.1578678,  2196,   274,   9932,   5714,  15646
153139,17010, 0.3463552, 0.0280014, 0.2300908,  3440,   160,   9932,   5714,  15646
153139,17033, 0.1922346, 0.0195946, 0.1747831,  2530,    29,  13161,   1480,  14641
153140,17010, 0.0317157, 0.0080504, 0.0230730,   315,    46,   9932,   5714,  15646
153140,17033, 0.1050072, 0.2885135, 0.1235571,  1382,   427,  13161,   1480,  14641
153142,21033, 0.0000000, 0.3130375, 0.1910561,     0,   910,   1856,   2907,   4763
153146,21185, 0.0000000, 0.1359873, 0.0918610,     0,   772,   2727,   5677,   8404
153146,21069, 0.0000000, 0.0083177, 0.0055965,     0,   142,   8301,  17072,  25373
153147,21185, 0.0000000, 0.0019376, 0.0013089,     0,    11,   2727,   5677,   8404
153148,21069, 0.0000000, 0.1160965, 0.0781145,     0,  1982,   8301,  17072,  25373
153149,21166, 0.0000000, 0.0728274, 0.0295432,     0,   238,   4788,   3268,   8056
153149,21069, 0.0001205, 0.0491448, 0.0331061,     1,   839,   8301,  17072,  25373
153150,21166, 0.0486633, 0.0768054, 0.0600794,   233,   251,   4788,   3268,   8056
153150,21069, 0.0000000, 0.0084349, 0.0056753,     0,   144,   8301,  17072,  25373
153151,21166, 0.9513367, 0.0458996, 0.5840367,  4555,   150,   4788,   3268,   8056
153153,21166, 0.0000000, 0.0559976, 0.0227160,     0,   183,   4788,   3268,   8056
153155,21121, 0.0000000, 0.3427673, 0.1925795,     0,   218,    496,    636,   1132
153157,21159, 0.7485656, 0.0556079, 0.5658548,  2218,    59,   2963,   1061,   4024
153158,21159, 0.2159973, 0.0697455, 0.1774354,   640,    74,   2963,   1061,   4024
153161,21150, 0.2095277, 0.0021820, 0.0749292,   519,    10,   2477,   4583,   7060
153164,21070, 0.0000000, 0.1193643, 0.1040193,     0,   691,    854,   5789,   6643
153164,21150, 0.0000000, 0.0283657, 0.0184136,     0,   130,   2477,   4583,   7060
153165,21070, 0.0000000, 0.0815339, 0.0710522,     0,   472,    854,   5789,   6643
153166,21070, 0.0000000, 0.1107272, 0.0964926,     0,   641,    854,   5789,   6643
153167,21070, 0.0000000, 0.0100190, 0.0087310,     0,    58,    854,   5789,   6643
153168,21070, 0.0000000, 0.0665054, 0.0579557,     0,   385,    854,   5789,   6643
153172,21203, 0.0000000, 0.4653361, 0.0732352,     0,   443,   5097,    952,   6049
153174,21203, 0.7100255, 0.1827731, 0.6270458,  3619,   174,   5097,    952,   6049
153177,21177, 0.0000000, 0.0806909, 0.0330032,     0,  1593,  28526,  19742,  48268
153177,21205, 0.0000000, 0.0040622, 0.0010010,     0,    23,  17314,   5662,  22976
153178,21177, 0.0021735, 0.0586567, 0.0252755,    62,  1158,  28526,  19742,  48268
153179,21177, 0.0233121, 0.0574916, 0.0372918,   665,  1135,  28526,  19742,  48268
154149,15008, 0.0000000, 0.0177926, 0.0142022,     0,   374,   5314,  21020,  26334
154150,15008, 0.0000000, 0.0300190, 0.0239614,     0,   631,   5314,  21020,  26334
154150,15082, 0.0000000, 0.0031455, 0.0018993,     0,   135,  28159,  42918,  71077
154151,15080, 0.0000000, 0.0089133, 0.0076717,     0,   198,   3595,  22214,  25809
154153,15080, 0.0000000, 0.0092734, 0.0079817,     0,   206,   3595,  22214,  25809
154154,15080, 0.0000000, 0.0172414, 0.0148398,     0,   383,   3595,  22214,  25809
154155,15080, 0.0000000, 0.0372738, 0.0320818,     0,   828,   3595,  22214,  25809
154156,15080, 0.0000000, 0.0030611, 0.0026347,     0,    68,   3595,  22214,  25809
154157,15080, 0.0000000, 0.0072927, 0.0062769,     0,   162,   3595,  22214,  25809
154158,15080, 0.0000000, 0.0167912, 0.0144523,     0,   373,   3595,  22214,  25809
154159,15080, 0.0000000, 0.0044116, 0.0037971,     0,    98,   3595,  22214,  25809
154160,15080, 0.0000000, 0.0264698, 0.0227828,     0,   588,   3595,  22214,  25809
154161,15117, 0.0000000, 0.0450169, 0.0361749,     0,   547,   2970,  12151,  15121
154162,15117, 0.0000000, 0.0951362, 0.0764500,     0,  1156,   2970,  12151,  15121
154164,15117, 0.0000000, 0.0045264, 0.0036373,     0,    55,   2970,  12151,  15121
154165,15117, 0.0000000, 0.0470743, 0.0378282,     0,   572,   2970,  12151,  15121
154165,15040, 0.0000000, 0.0554682, 0.0262962,     0,   882,  17640,  15901,  33541
154166,12049, 0.0000000, 0.1792303, 0.0975082,     0,  1127,   5270,   6288,  11558
154166,15040, 0.0000000, 0.0225143, 0.0106735,     0,   358,  17640,  15901,  33541
154166,15107, 0.0000000, 0.1074107, 0.0402513,     0,   487,   7565,   4534,  12099
154167,15107, 0.0000000, 0.0560212, 0.0209935,     0,   254,   7565,   4534,  12099
154168,15107, 0.0000000, 0.0787384, 0.0295066,     0,   357,   7565,   4534,  12099
154169,15107, 0.0000000, 0.1444640, 0.0541367,     0,   655,   7565,   4534,  12099
154171,15119, 0.0000000, 0.1528150, 0.1149404,     0,  1881,   4056,  12309,  16365
154174,17005, 0.0000000, 0.0738949, 0.0580720,     0,   550,   2028,   7443,   9471
154174,15052, 0.0000000, 0.0894249, 0.0613487,     0,  1572,   8045,  17579,  25624
154177,17015, 0.0000000, 0.0018425, 0.0006403,     0,    16,  16306,   8684,  24990
154178,17015, 0.4127928, 0.2498848, 0.3561825,  6731,  2170,  16306,   8684,  24990
154179,17015, 0.0000000, 0.1921925, 0.0667867,     0,  1669,  16306,   8684,  24990
154180,17015, 0.0000000, 0.0003455, 0.0001200,     0,     3,  16306,   8684,  24990
154180,17018, 0.0000000, 0.0482274, 0.0031075,     0,   336, 101159,   6967, 108126
154181,17028, 0.0000000, 0.0561838, 0.0124641,     0,   790,  49321,  14061,  63382
154182,17028, 0.0560208, 0.2112225, 0.0904515,  2763,  2970,  49321,  14061,  63382
154183,17028, 0.0814258, 0.2400256, 0.1166104,  4016,  3375,  49321,  14061,  63382
154184,17028, 0.0005880, 0.0115923, 0.0030293,    29,   163,  49321,  14061,  63382
154184,17008, 0.0383708, 0.0111745, 0.0370007,  3042,    47,  79279,   4206,  83485
154186,17024, 0.1065163, 0.0106265, 0.0782717,  3673,   153,  34483,  14398,  48881
154187,17024, 0.0000000, 0.0054869, 0.0016162,     0,    79,  34483,  14398,  48881
154190,17004, 0.0000000, 0.0001641, 0.0000634,     0,     5,  48393,  30473,  78866
154191,17004, 0.2472258, 0.0047255, 0.1535262, 11964,   144,  48393,  30473,  78866
154192,17004, 0.0002273, 0.0386244, 0.0150635,    11,  1177,  48393,  30473,  78866
154193,17004, 0.0000000, 0.0527352, 0.0203763,     0,  1607,  48393,  30473,  78866
154194,17004, 0.0000000, 0.0422997, 0.0163442,     0,  1289,  48393,  30473,  78866
154195,17004, 0.0000000, 0.0845010, 0.0326503,     0,  2575,  48393,  30473,  78866
154196,17004, 0.0000000, 0.0365898, 0.0141379,     0,  1115,  48393,  30473,  78866
154198,17033, 0.5003419, 0.0891892, 0.4587801,  6585,   132,  13161,   1480,  14641
154199,17033, 0.0462731, 0.5966216, 0.1019056,   609,   883,  13161,   1480,  14641
154200,21005, 0.4542421, 0.0319285, 0.3394655,   953,    25,   2098,    783,   2881
154201,21005, 0.5457579, 0.7586207, 0.6036099,  1145,   594,   2098,    783,   2881
154203,21165, 0.0050188, 0.7674419, 0.2348817,     4,   264,    797,    344,   1141
154205,21022, 0.0000000, 0.0093324, 0.0033379,     0,    39,   7505,   4179,  11684
154205,21069, 0.0000000, 0.0352038, 0.0236866,     0,   601,   8301,  17072,  25373
154206,21069, 0.0628840, 0.0009372, 0.0212036,   522,    16,   8301,  17072,  25373
154207,21069, 0.0490302, 0.0457474, 0.0468214,   407,   781,   8301,  17072,  25373
154208,21069, 0.2668353, 0.0185098, 0.0997517,  2215,   316,   8301,  17072,  25373
154209,21069, 0.0089146, 0.0294634, 0.0227407,    74,   503,   8301,  17072,  25373
154210,21166, 0.0000000, 0.2818238, 0.1143247,     0,   921,   4788,   3268,   8056
154212,21166, 0.0000000, 0.2567320, 0.1041460,     0,   839,   4788,   3268,   8056
154216,21159, 0.0000000, 0.1093308, 0.0288270,     0,   116,   2963,   1061,   4024
154217,21159, 0.0000000, 0.0037700, 0.0009940,     0,     4,   2963,   1061,   4024
154217,21150, 0.0000000, 0.0004364, 0.0002833,     0,     2,   2477,   4583,   7060
154219,21150, 0.0662091, 0.1200087, 0.1011331,   164,   550,   2477,   4583,   7060
154220,21150, 0.7242633, 0.0366572, 0.2779037,  1794,   168,   2477,   4583,   7060
154222,21150, 0.0000000, 0.0576042, 0.0373938,     0,   264,   2477,   4583,   7060
154224,21070, 0.0000000, 0.0012092, 0.0010537,     0,     7,    854,   5789,   6643
154228,21098, 0.0905250, 0.0118395, 0.0328080,   150,    54,   1657,   4561,   6218
154229,21098, 0.9094750, 0.0219250, 0.2584432,  1507,   100,   1657,   4561,   6218
154230,21098, 0.0000000, 0.3525543, 0.2586040,     0,  1608,   1657,   4561,   6218
154236,21205, 0.0000000, 0.0187213, 0.0046135,     0,   106,  17314,   5662,  22976
154237,21177, 0.0000000, 0.0329754, 0.0134872,     0,   651,  28526,  19742,  48268
154237,21205, 0.0000000, 0.1231014, 0.0303360,     0,   697,  17314,   5662,  22976
154238,21205, 0.0039275, 0.1400565, 0.0374739,    68,   793,  17314,   5662,  22976
155208,15082, 0.0000000, 0.0180810, 0.0109177,     0,   776,  28159,  42918,  71077
155209,15082, 0.0000000, 0.0349504, 0.0211039,     0,  1500,  28159,  42918,  71077
155210,15082, 0.0000000, 0.0217391, 0.0131266,     0,   933,  28159,  42918,  71077
155211,15082, 0.0000000, 0.0015844, 0.0009567,     0,    68,  28159,  42918,  71077
155212,15080, 0.0000000, 0.0018457, 0.0015886,     0,    41,   3595,  22214,  25809
155213,15080, 0.0000000, 0.0198073, 0.0170483,     0,   440,   3595,  22214,  25809
155214,15080, 0.0000000, 0.0706311, 0.0607927,     0,  1569,   3595,  22214,  25809
155215,15080, 0.0000000, 0.0189520, 0.0163121,     0,   421,   3595,  22214,  25809
155218,15080, 0.0000000, 0.0037814, 0.0032547,     0,    84,   3595,  22214,  25809
155218,15004, 0.0000000, 0.0358882, 0.0282714,     0,   420,   3153,  11703,  14856
155219,15117, 0.0000000, 0.0093819, 0.0075392,     0,   114,   2970,  12151,  15121
155219,15004, 0.0000000, 0.0637443, 0.0502154,     0,   746,   3153,  11703,  14856
155220,15117, 0.0000000, 0.0089705, 0.0072085,     0,   109,   2970,  12151,  15121
155221,15117, 0.0000000, 0.0334952, 0.0269162,     0,   407,   2970,  12151,  15121
155222,15117, 0.0000000, 0.0227142, 0.0182528,     0,   276,   2970,  12151,  15121
155223,15117, 0.0000000, 0.0035388, 0.0028437,     0,    43,   2970,  12151,  15121
155224,15040, 0.0000000, 0.0513175, 0.0243284,     0,   816,  17640,  15901,  33541
155226,15107, 1.0000000, 0.0630790, 0.6488966,  7565,   286,   7565,   4534,  12099
155227,15107, 0.0000000, 0.5163211, 0.1934871,     0,  2341,   7565,   4534,  12099
155230,15119, 0.0000000, 0.0270534, 0.0203483,     0,   333,   4056,  12309,  16365
155231,15119, 0.0000000, 0.0169794, 0.0127712,     0,   209,   4056,  12309,  16365
155232,15119, 0.0000000, 0.0301405, 0.0226703,     0,   371,   4056,  12309,  16365
155232,15052, 0.0000000, 0.0187155, 0.0128395,     0,   329,   8045,  17579,  25624
155233,15052, 0.0000000, 0.1250356, 0.0857790,     0,  2198,   8045,  17579,  25624
155236,17015, 0.0000000, 0.0154307, 0.0053621,     0,   134,  16306,   8684,  24990
155237,17015, 0.0000000, 0.0010364, 0.0003601,     0,     9,  16306,   8684,  24990
155238,17015, 0.0000000, 0.0050668, 0.0017607,     0,    44,  16306,   8684,  24990
155239,17015, 0.0000000, 0.1574159, 0.0547019,     0,  1367,  16306,   8684,  24990
155240,17028, 0.0046025, 0.0013513, 0.0038812,   227,    19,  49321,  14061,  63382
155241,17028, 0.1731919, 0.1887490, 0.1766432,  8542,  2654,  49321,  14061,  63382
155242,17028, 0.0722005, 0.0296565, 0.0627623,  3561,   417,  49321,  14061,  63382
155242,17008, 0.0297431, 0.0007133, 0.0282805,  2358,     3,  79279,   4206,  83485
155243,17008, 0.0482473, 0.5021398, 0.0711146,  3825,  2112,  79279,   4206,  83485
155243,17028, 0.0067111, 0.0153616, 0.0086302,   331,   216,  49321,  14061,  63382
155245,17024, 0.0000000, 0.0004862, 0.0001432,     0,     7,  34483,  14398,  48881
155246,17024, 0.0000000, 0.0115294, 0.0033960,     0,   166,  34483,  14398,  48881
155246,17029, 0.0000000, 0.0188035, 0.0032097,     0,   314,  81128,  16699,  97827
155247,17029, 0.0000000, 0.0476675, 0.0081368,     0,   796,  81128,  16699,  97827
155250,17004, 0.1230137, 0.0073508, 0.0783227,  5953,   224,  48393,  30473,  78866
155251,17004, 0.2519993, 0.0247760, 0.1642026, 12195,   755,  48393,  30473,  78866
155251,17006, 0.0824269, 0.0213167, 0.0765038, 13042,   362, 158225,  16982, 175207
155252,17006, 0.0790204, 0.0903898, 0.0801224, 12503,  1535, 158225,  16982, 175207
155252,17004, 0.0000000, 0.0462377, 0.0178657,     0,  1409,  48393,  30473,  78866
155253,17004, 0.0000000, 0.0015423, 0.0005959,     0,    47,  48393,  30473,  78866
155253,17006, 0.0155475, 0.0706631, 0.0208896,  2460,  1200, 158225,  16982, 175207
155253,17030, 0.0000000, 0.0858841, 0.0268538,     0,  1257,  32173,  14636,  46809
155254,17030, 0.0000000, 0.0014348, 0.0004486,     0,    21,  32173,  14636,  46809
155255,17030, 0.0000000, 0.0383301, 0.0119849,     0,   561,  32173,  14636,  46809
155256,17030, 0.0000000, 0.1137606, 0.0355701,     0,  1665,  32173,  14636,  46809
155257,17033, 0.1546995, 0.0060811, 0.1396763,  2036,     9,  13161,   1480,  14641
155257,17032, 0.1321832, 0.3169291, 0.1425113,  1134,   161,   8579,    508,   9087
155258,17032, 0.2697284, 0.0925197, 0.2598217,  2314,    47,   8579,    508,   9087
155259,21033, 1.0000000, 0.0240798, 0.4043670,  1856,    70,   1856,   2907,   4763
155260,21005, 0.0000000, 0.2094508, 0.0569247,     0,   164,   2098,    783,   2881
155262,21165, 0.0000000, 0.2325581, 0.0701139,     0,    80,    797,    344,   1141
155262,21022, 0.0000000, 0.1665470, 0.0595686,     0,   696,   7505,   4179,  11684
155263,21022, 0.0000000, 0.0732233, 0.0261897,     0,   306,   7505,   4179,  11684
155265,21069, 0.1829900, 0.0029873, 0.0618768,  1519,    51,   8301,  17072,  25373
155266,21069, 0.0671003, 0.0082006, 0.0274701,   557,   140,   8301,  17072,  25373
155267,21069, 0.2008192, 0.0223758, 0.0807551,  1667,   382,   8301,  17072,  25373
155268,21069, 0.1613059, 0.0292291, 0.0724392,  1339,   499,   8301,  17072,  25373
155269,21166, 0.0000000, 0.0003060, 0.0001241,     0,     1,   4788,   3268,   8056
155269,21069, 0.0000000, 0.0815956, 0.0549009,     0,  1393,   8301,  17072,  25373
155275,21159, 0.0000000, 0.0047125, 0.0012425,     0,     5,   2963,   1061,   4024
155278,21150, 0.0000000, 0.0346934, 0.0225212,     0,   159,   2477,   4583,   7060
155280,21150, 0.0000000, 0.0977526, 0.0634561,     0,   448,   2477,   4583,   7060
155281,21150, 0.0000000, 0.0331660, 0.0215297,     0,   152,   2477,   4583,   7060
155288,21020, 0.0000000, 0.0404412, 0.0017118,     0,    11,   6154,    272,   6426
155288,21079, 0.2240679, 0.0065460, 0.1176027,   607,    17,   2709,   2597,   5306
155289,21079, 0.7338501, 0.4166346, 0.5785903,  1988,  1082,   2709,   2597,   5306
155295,21205, 0.3500058, 0.0625221, 0.2791609,  6060,   354,  17314,   5662,  22976
155296,21205, 0.0504794, 0.3062522, 0.1135097,   874,  1734,  17314,   5662,  22976
155297,21205, 0.1968349, 0.0010597, 0.1485898,  3408,     6,  17314,   5662,  22976
156267,15082, 0.0000000, 0.0171956, 0.0103831,     0,   738,  28159,  42918,  71077
156268,15082, 0.0000000, 0.0052892, 0.0031937,     0,   227,  28159,  42918,  71077
156269,15082, 0.0000000, 0.0266089, 0.0160671,     0,  1142,  28159,  42918,  71077
156270,15082, 0.0000000, 0.0291020, 0.0175725,     0,  1249,  28159,  42918,  71077
156271,15082, 0.0000000, 0.0173121, 0.0104535,     0,   743,  28159,  42918,  71077
156272,15080, 0.0000000, 0.0036013, 0.0030997,     0,    80,   3595,  22214,  25809
156272,15082, 0.0000000, 0.0035649, 0.0021526,     0,   153,  28159,  42918,  71077
156273,15080, 0.0000000, 0.0398397, 0.0342904,     0,   885,   3595,  22214,  25809
156274,15080, 0.0000000, 0.1174485, 0.1010888,     0,  2609,   3595,  22214,  25809
156275,15080, 0.0000000, 0.0356532, 0.0306870,     0,   792,   3595,  22214,  25809
156276,15004, 0.0000000, 0.0234982, 0.0185110,     0,   275,   3153,  11703,  14856
156276,15080, 0.0000000, 0.0094985, 0.0081754,     0,   211,   3595,  22214,  25809
156277,15004, 0.0000000, 0.0406733, 0.0320409,     0,   476,   3153,  11703,  14856
156278,15004, 0.0000000, 0.0102538, 0.0080775,     0,   120,   3153,  11703,  14856
156279,15004, 0.0000000, 0.0529779, 0.0417340,     0,   620,   3153,  11703,  14856
156280,15004, 0.0000000, 0.0941639, 0.0741788,     0,  1102,   3153,  11703,  14856
156281,15004, 0.0000000, 0.0140989, 0.0111066,     0,   165,   3153,  11703,  14856
156281,15021, 0.0000000, 0.0540309, 0.0436501,     0,  1579,   6950,  29224,  36174
156282,15040, 0.0000000, 0.0206276, 0.0097791,     0,   328,  17640,  15901,  33541
156283,15040, 0.0000000, 0.1234514, 0.0585254,     0,  1963,  17640,  15901,  33541
156284,15040, 0.0715420, 0.1836362, 0.1246832,  1262,  2920,  17640,  15901,  33541
156285,15040, 0.4852041, 0.0596189, 0.2834442,  8559,   948,  17640,  15901,  33541
156286,15040, 0.0000000, 0.0215081, 0.0101965,     0,   342,  17640,  15901,  33541
156288,15119, 0.9893984, 0.0937525, 0.3157348,  4013,  1154,   4056,  12309,  16365
156289,15119, 0.0000000, 0.0138110, 0.0103880,     0,   170,   4056,  12309,  16365
156290,15119, 0.0000000, 0.0328215, 0.0246868,     0,   404,   4056,  12309,  16365
156292,15052, 0.0000000, 0.0346436, 0.0237668,     0,   609,   8045,  17579,  25624
156294,17015, 0.0000000, 0.0300553, 0.0104442,     0,   261,  16306,   8684,  24990
156295,17015, 0.0000000, 0.0036849, 0.0012805,     0,    32,  16306,   8684,  24990
156298,17018, 0.0000000, 0.2206115, 0.0142149,     0,  1537, 101159,   6967, 108126
156299,17018, 0.0284997, 0.1095163, 0.0337199,  2883,   763, 101159,   6967, 108126
156300,17028, 0.1835729, 0.0018491, 0.1432583,  9054,    26,  49321,  14061,  63382
156301,17008, 0.0448542, 0.0290062, 0.0440558,  3556,   122,  79279,   4206,  83485
156301,17018, 0.0403721, 0.1265968, 0.0459279,  4084,   882, 101159,   6967, 108126
156302,17008, 0.1381955, 0.1640514, 0.1394981, 10956,   690,  79279,   4206,  83485
156303,17008, 0.0000000, 0.0002378, 0.0000120,     0,     1,  79279,   4206,  83485
156305,17024, 0.0000000, 0.0605640, 0.0178392,     0,   872,  34483,  14398,  48881
156305,17029, 0.0000000, 0.0803042, 0.0137079,     0,  1341,  81128,  16699,  97827
156306,17029, 0.0000000, 0.0063477, 0.0010835,     0,   106,  81128,  16699,  97827
156309,17006, 0.0005625, 0.3103286, 0.0305867,    89,  5270, 158225,  16982, 175207
156310,17006, 0.2250972, 0.0421034, 0.2073604, 35616,   715, 158225,  16982, 175207
156311,17030, 0.3964815, 0.0427029, 0.2858638, 12756,   625,  32173,  14636,  46809
156311,17006, 0.1344604, 0.0391591, 0.1252233, 21275,   665, 158225,  16982, 175207
156313,17030, 0.0000000, 0.0683930, 0.0213848,     0,  1001,  32173,  14636,  46809
156314,17030, 0.0000000, 0.0008199, 0.0002564,     0,    12,  32173,  14636,  46809
156316,17032, 0.0000000, 0.0078740, 0.0004402,     0,     4,   8579,    508,   9087
156317,17032, 0.5952908, 0.5570866, 0.5931550,  5107,   283,   8579,    508,   9087
156318,17032, 0.0000000, 0.0137795, 0.0007703,     0,     7,   8579,    508,   9087
156318,17022, 0.0000000, 0.0036570, 0.0004703,     0,     9,  16677,   2461,  19138
156319,21033, 0.0000000, 0.3869969, 0.2361957,     0,  1125,   1856,   2907,   4763
156321,21022, 0.0000000, 0.1373534, 0.0491270,     0,   574,   7505,   4179,  11684
156322,21022, 0.0000000, 0.2354630, 0.0842177,     0,   984,   7505,   4179,  11684
156323,21022, 0.0619587, 0.0038287, 0.0411674,   465,    16,   7505,   4179,  11684
156324,21069, 0.0000000, 0.0142924, 0.0096165,     0,   244,   8301,  17072,  25373
156324,21022, 0.0000000, 0.2648959, 0.0947450,     0,  1107,   7505,   4179,  11684
156326,21069, 0.0000000, 0.0890347, 0.0599062,     0,  1520,   8301,  17072,  25373
156327,21069, 0.0000000, 0.1416940, 0.0953376,     0,  2419,   8301,  17072,  25373
156328,21069, 0.0000000, 0.0087277, 0.0058724,     0,   149,   8301,  17072,  25373
156332,21121, 1.0000000, 0.2893082, 0.6007067,   496,   184,    496,    636,   1132
156337,21150, 0.0000000, 0.3035130, 0.1970255,     0,  1391,   2477,   4583,   7060
156338,21150, 0.0000000, 0.1878682, 0.1219547,     0,   861,   2477,   4583,   7060
156344,21193, 0.0000000, 0.3755191, 0.3042294,     0,  1899,   1185,   5057,   6242
156347,21079, 0.0158730, 0.0003851, 0.0082925,    43,     1,   2709,   2597,   5306
156347,21020, 0.0000000, 0.0036765, 0.0001556,     0,     1,   6154,    272,   6426
156348,21171, 0.0027100, 0.8861893, 0.2080238,     7,   693,   2583,    782,   3365
156349,21189, 0.0000000, 0.4950677, 0.1095376,     0,  2158,  15342,   4359,  19701
156351,21189, 0.0000000, 0.0082588, 0.0018273,     0,    36,  15342,   4359,  19701
156351,21154, 0.0000000, 0.0051432, 0.0011317,     0,    81,  55822,  15749,  71571
156352,21154, 0.0000000, 0.1732173, 0.0381160,     0,  2728,  55822,  15749,  71571
156353,21154, 0.0000000, 0.0913074, 0.0200919,     0,  1438,  55822,  15749,  71571
156354,21205, 0.0000000, 0.0351466, 0.0086612,     0,   199,  17314,   5662,  22976
156355,21205, 0.2868777, 0.2938891, 0.2886055,  4967,  1664,  17314,   5662,  22976
157326,15082, 0.0000000, 0.0039610, 0.0023918,     0,   170,  28159,  42918,  71077
157327,15082, 0.0000000, 0.0157044, 0.0094827,     0,   674,  28159,  42918,  71077
157328,15082, 0.0000000, 0.0262361, 0.0158420,     0,  1126,  28159,  42918,  71077
157329,15082, 0.0000000, 0.0253041, 0.0152792,     0,  1086,  28159,  42918,  71077
157330,15082, 0.0000000, 0.0034251, 0.0020682,     0,   147,  28159,  42918,  71077
157331,15082, 0.0000000, 0.0050562, 0.0030530,     0,   217,  28159,  42918,  71077
157332,15080, 0.0000000, 0.0116593, 0.0100353,     0,   259,   3595,  22214,  25809
157332,15097, 0.0000000, 0.0236739, 0.0200690,     0,   349,   2648,  14742,  17390
157332,15082, 0.0000000, 0.0198984, 0.0120151,     0,   854,  28159,  42918,  71077
157334,15080, 0.4047288, 0.0464572, 0.0963617,  1455,  1032,   3595,  22214,  25809
157336,15004, 0.9987314, 0.1145860, 0.3022348,  3149,  1341,   3153,  11703,  14856
157337,15004, 0.0012686, 0.0995471, 0.0786887,     4,  1165,   3153,  11703,  14856
157338,15004, 0.0000000, 0.0294796, 0.0232229,     0,   345,   3153,  11703,  14856
157339,15004, 0.0000000, 0.0116210, 0.0091546,     0,   136,   3153,  11703,  14856
157340,15021, 0.0000000, 0.0313099, 0.0252944,     0,   915,   6950,  29224,  36174
157341,15021, 0.0000000, 0.0152956, 0.0123569,     0,   447,   6950,  29224,  36174
157343,15040, 0.1816327, 0.0691780, 0.1283206,  3204,  1100,  17640,  15901,  33541
157344,15040, 0.2616213, 0.0559084, 0.1640977,  4615,   889,  17640,  15901,  33541
157345,15040, 0.0000000, 0.0472297, 0.0223905,     0,   751,  17640,  15901,  33541
157346,15113, 0.0000000, 0.0234649, 0.0168359,     0,  1010,  16948,  43043,  59991
157346,15119, 0.0000000, 0.0233163, 0.0175374,     0,   287,   4056,  12309,  16365
157347,15119, 0.0106016, 0.2745146, 0.2091048,    43,  3379,   4056,  12309,  16365
157348,15088, 0.0000000, 0.0246070, 0.0127878,     0,  1163,  43683,  47263,  90946
157351,15052, 0.0000000, 0.0351556, 0.0241180,     0,   618,   8045,  17579,  25624
157352,15052, 0.0000000, 0.0024461, 0.0016781,     0,    43,   8045,  17579,  25624
157352,17015, 0.0000000, 0.0910871, 0.0316527,     0,   791,  16306,   8684,  24990
157354,17015, 0.0000000, 0.0158913, 0.0055222,     0,   138,  16306,   8684,  24990
157358,17018, 0.0069692, 0.2233386, 0.0209108,   705,  1556, 101159,   6967, 108126
157359,17018, 0.3764964, 0.0489450, 0.3553909, 38086,   341, 101159,   6967, 108126
157360,17008, 0.1547572, 0.2503566, 0.1595736, 12269,  1053,  79279,   4206,  83485
157360,17018, 0.0429126, 0.0686092, 0.0445684,  4341,   478, 101159,   6967, 108126
157361,17008, 0.4344278, 0.0342368, 0.4142660, 34441,   144,  79279,   4206,  83485
157362,17008, 0.0004415, 0.0066572, 0.0007546,    35,    28,  79279,   4206,  83485
157362,17011, 0.0000000, 0.3321960, 0.0123583,     0,  2434, 189626,   7327, 196953
157364,17029, 0.0000000, 0.0265285, 0.0045284,     0,   443,  81128,  16699,  97827
157365,17029, 0.0138300, 0.0043715, 0.0122154,  1122,    73,  81128,  16699,  97827
157366,17029, 0.0000000, 0.0013773, 0.0002351,     0,    23,  81128,  16699,  97827
157368,17006, 0.0000126, 0.0505830, 0.0049142,     2,   859, 158225,  16982, 175207
157369,17006, 0.2360120, 0.0383347, 0.2168521, 37343,   651, 158225,  16982, 175207
157370,17030, 0.0000000, 0.0233670, 0.0073063,     0,   342,  32173,  14636,  46809
157370,17006, 0.0703618, 0.0242021, 0.0658878, 11133,   411, 158225,  16982, 175207
157371,17030, 0.0000000, 0.0000683, 0.0000214,     0,     1,  32173,  14636,  46809
157372,17030, 0.0000000, 0.0002050, 0.0000641,     0,     3,  32173,  14636,  46809
157373,17030, 0.0000000, 0.0142799, 0.0044650,     0,   209,  32173,  14636,  46809
157374,17016, 0.0000000, 0.0001227, 0.0000593,     0,     1,   8705,   8153,  16858
157374,17030, 0.0000000, 0.0001366, 0.0000427,     0,     2,  32173,  14636,  46809
157375,17016, 0.0000000, 0.0001227, 0.0000593,     0,     1,   8705,   8153,  16858
157376,17022, 0.0000000, 0.0069078, 0.0008883,     0,    17,  16677,   2461,  19138
157377,17032, 0.0000000, 0.0118110, 0.0006603,     0,     6,   8579,    508,   9087
157377,17022, 0.0000000, 0.0004063, 0.0000523,     0,     1,  16677,   2461,  19138
157378,21033, 0.0000000, 0.2758858, 0.1683813,     0,   802,   1856,   2907,   4763
157378,17022, 0.0000000, 0.0016254, 0.0002090,     0,     4,  16677,   2461,  19138
157379,21022, 0.5028648, 0.0890165, 0.3548442,  3774,   372,   7505,   4179,  11684
157382,21188, 0.0000000, 0.2418113, 0.1235612,     0,  2104,   8327,   8701,  17028
157383,21188, 0.0000000, 0.0051718, 0.0026427,     0,    45,   8327,   8701,  17028
157385,21069, 0.0000000, 0.1122891, 0.0755528,     0,  1917,   8301,  17072,  25373
157386,21069, 0.0000000, 0.0020501, 0.0013794,     0,    35,   8301,  17072,  25373
157386,21019, 0.0000000, 0.0356539, 0.0076341,     0,   970,  99856,  27206, 127062
157387,21069, 0.0000000, 0.0733950, 0.0493832,     0,  1253,   8301,  17072,  25373
157390,21019, 0.0000000, 0.0402117, 0.0086100,     0,  1094,  99856,  27206, 127062
157392,21159, 0.0000000, 0.5353440, 0.1411531,     0,   568,   2963,   1061,   4024
157393,21121, 0.0000000, 0.3679245, 0.2067138,     0,   234,    496,    636,   1132
157401,21193, 0.2320675, 0.0245205, 0.0639218,   275,   124,   1185,   5057,   6242
157405,21020, 0.6031849, 0.3602941, 0.5929039,  3712,    98,   6154,    272,   6426
157406,21020, 0.3968151, 0.4926471, 0.4008715,  2442,   134,   6154,    272,   6426
157406,21079, 0.0000000, 0.5652676, 0.2766679,     0,  1468,   2709,   2597,   5306
157407,21171, 0.8931475, 0.1138107, 0.7120357,  2307,    89,   2583,    782,   3365
157407,21079, 0.0000000, 0.0069311, 0.0033924,     0,    18,   2709,   2597,   5306
157408,21189, 0.0000000, 0.0428997, 0.0094919,     0,   187,  15342,   4359,  19701
157409,21189, 0.0180550, 0.0211058, 0.0187300,   277,    92,  15342,   4359,  19701
157410,21189, 0.0000000, 0.0841936, 0.0186285,     0,   367,  15342,   4359,  19701
157410,21154, 0.0180753, 0.0048257, 0.0151598,  1009,    76,  55822,  15749,  71571
157411,21154, 0.0000000, 0.0952441, 0.0209582,     0,  1500,  55822,  15749,  71571
157412,21154, 0.0000896, 0.0006350, 0.0002096,     5,    10,  55822,  15749,  71571
157413,21205, 0.0000000, 0.0151890, 0.0037430,     0,    86,  17314,   5662,  22976
158385,15082, 0.0000000, 0.0109511, 0.0066125,     0,   470,  28159,  42918,  71077
158386,15082, 0.5132285, 0.0637262, 0.2418082, 14452,  2735,  28159,  42918,  71077
158387,15082, 0.0140630, 0.1169672, 0.0761991,   396,  5020,  28159,  42918,  71077
158388,15082, 0.0000000, 0.0185470, 0.0111991,     0,   796,  28159,  42918,  71077
158390,15082, 0.0000000, 0.0462743, 0.0279415,     0,  1986,  28159,  42918,  71077
158391,15097, 0.0000000, 0.0158052, 0.0133985,     0,   233,   2648,  14742,  17390
158391,15082, 0.0000000, 0.0096929, 0.0058528,     0,   416,  28159,  42918,  71077
158392,15097, 0.0000000, 0.0493149, 0.0418056,     0,   727,   2648,  14742,  17390
158393,15097, 0.0000000, 0.0130918, 0.0110983,     0,   193,   2648,  14742,  17390
158394,15004, 0.0000000, 0.2536956, 0.1998519,     0,  2969,   3153,  11703,  14856
158396,15004, 0.0000000, 0.0405879, 0.0319736,     0,   475,   3153,  11703,  14856
158397,15004, 0.0000000, 0.0503290, 0.0396473,     0,   589,   3153,  11703,  14856
158398,15021, 0.0000000, 0.0159800, 0.0129098,     0,   467,   6950,  29224,  36174
158399,15021, 0.0000000, 0.0130714, 0.0105601,     0,   382,   6950,  29224,  36174
158400,15021, 0.0000000, 0.0349713, 0.0282523,     0,  1022,   6950,  29224,  36174
158401,15040, 0.0000000, 0.0809383, 0.0383709,     0,  1287,  17640,  15901,  33541
158402,15040, 0.0000000, 0.0660336, 0.0313050,     0,  1050,  17640,  15901,  33541
158403,15040, 0.0000000, 0.0371675, 0.0176202,     0,   591,  17640,  15901,  33541
158404,15040, 0.0000000, 0.0181750, 0.0086163,     0,   289,  17640,  15901,  33541
158404,15113, 0.0000000, 0.0761796, 0.0546582,     0,  3279,  16948,  43043,  59991
158405,15119, 0.0000000, 0.0812414, 0.0611060,     0,  1000,   4056,  12309,  16365
158406,15119, 0.0000000, 0.0761232, 0.0572563,     0,   937,   4056,  12309,  16365
158407,15088, 0.0000000, 0.0009098, 0.0004728,     0,    43,  43683,  47263,  90946
158408,15052, 0.0000000, 0.0208772, 0.0143225,     0,   367,   8045,  17579,  25624
158411,15052, 0.0000000, 0.0040958, 0.0028099,     0,    72,   8045,  17579,  25624
158411,15063, 0.0000000, 0.0138266, 0.0117285,     0,   373,   4826,  26977,  31803
158412,17015, 0.0000000, 0.0170428, 0.0059224,     0,   148,  16306,   8684,  24990
158413,17015, 0.0000000, 0.0042607, 0.0014806,     0,    37,  16306,   8684,  24990
158417,17018, 0.0054370, 0.0907134, 0.0109317,   550,   632, 101159,   6967, 108126
158418,17018, 0.1433585, 0.0490886, 0.1372843, 14502,   342, 101159,   6967, 108126
158420,17011, 0.1771276, 0.0028661, 0.1706448, 33588,    21, 189626,   7327, 196953
158421,17011, 0.0776845, 0.4284154, 0.0907323, 14731,  3139, 189626,   7327, 196953
158422,17011, 0.0426418, 0.0685137, 0.0436043,  8086,   502, 189626,   7327, 196953
158423,17029, 0.0114880, 0.0673693, 0.0210269,   932,  1125,  81128,  16699,  97827
158424,17029, 0.3031383, 0.0144919, 0.2538665, 24593,   242,  81128,  16699,  97827
158425,17029, 0.0167760, 0.0286844, 0.0188087,  1361,   479,  81128,  16699,  97827
158426,17029, 0.0139286, 0.0215582, 0.0152310,  1130,   360,  81128,  16699,  97827
158427,17029, 0.0644414, 0.0121564, 0.0555164,  5228,   203,  81128,  16699,  97827
158427,17006, 0.0159330, 0.1529266, 0.0292112,  2521,  2597, 158225,  16982, 175207
158428,17006, 0.0335914, 0.1599929, 0.0458429,  5315,  2717, 158225,  16982, 175207
158429,17030, 0.0000000, 0.1026237, 0.0320878,     0,  1502,  32173,  14636,  46809
158430,17030, 0.0002797, 0.1055616, 0.0331987,     9,  1545,  32173,  14636,  46809
158431,17030, 0.2468840, 0.0426346, 0.1830204,  7943,   624,  32173,  14636,  46809
158432,17030, 0.1599478, 0.0054660, 0.1116452,  5146,    80,  32173,  14636,  46809
158433,17016, 0.0000000, 0.0028210, 0.0013643,     0,    23,   8705,   8153,  16858
158434,17016, 0.4929351, 0.0239176, 0.2661051,  4291,   195,   8705,   8153,  16858
158435,17016, 0.0240092, 0.3201275, 0.1672203,   209,  2610,   8705,   8153,  16858
158436,17022, 0.0010793, 0.0451036, 0.0067405,    18,   111,  16677,   2461,  19138
158437,17022, 0.0854470, 0.0910199, 0.0861636,  1425,   224,  16677,   2461,  19138
158440,21188, 0.0000000, 0.0975750, 0.0498591,     0,   849,   8327,   8701,  17028
158443,21022, 0.0728847, 0.0203398, 0.0540911,   547,    85,   7505,   4179,  11684
158445,21019, 0.0021731, 0.0261339, 0.0073035,   217,   711,  99856,  27206, 127062
158446,21019, 0.0292021, 0.0137102, 0.0258850,  2916,   373,  99856,  27206, 127062
158447,21069, 0.0000000, 0.0197399, 0.0132818,     0,   337,   8301,  17072,  25373
158447,21019, 0.0000000, 0.0235242, 0.0050369,     0,   640,  99856,  27206, 127062
158448,21019, 0.0000000, 0.0038962, 0.0008342,     0,   106,  99856,  27206, 127062
158450,21159, 0.0000000, 0.0037700, 0.0009940,     0,     4,   2963,   1061,   4024
158450,21019, 0.0000000, 0.0064324, 0.0013773,     0,   175,  99856,  27206, 127062
158451,21159, 0.0000000, 0.0084826, 0.0022366,     0,     9,   2963,   1061,   4024
158452,21114, 0.0000000, 0.0050755, 0.0001052,     0,   162,1507901,  31918,1539819
158454,21114, 0.0000000, 0.0133467, 0.0002767,     0,   426,1507901,  31918,1539819
158455,21114, 0.0000000, 0.0120935, 0.0002507,     0,   386,1507901,  31918,1539819
158456,21114, 0.0000000, 0.0259101, 0.0005371,     0,   827,1507901,  31918,1539819
158458,21193, 0.0000000, 0.0253114, 0.0205062,     0,   128,   1185,   5057,   6242
158459,21193, 0.0118143, 0.2028871, 0.1666133,    14,  1026,   1185,   5057,   6242
158460,21193, 0.7552742, 0.0259047, 0.1643704,   895,   131,   1185,   5057,   6242
158462,21153, 0.0000000, 0.0425314, 0.0225490,     0,   457,   9522,  10745,  20267
158463,21153, 0.0000000, 0.0572359, 0.0303449,     0,   615,   9522,  10745,  20267
158464,21020, 0.0000000, 0.0477941, 0.0020230,     0,    13,   6154,    272,   6426
158464,21153, 0.2860743, 0.0012099, 0.1350471,  2724,    13,   9522,  10745,  20267
158465,21020, 0.0000000, 0.0551471, 0.0023343,     0,    15,   6154,    272,   6426
158465,21182, 0.3269598, 0.6428571, 0.3351955,  1539,    81,   4707,    126,   4833
158465,21079, 0.0000000, 0.0042357, 0.0020731,     0,    11,   2709,   2597,   5306
158466,21189, 0.0925564, 0.0011471, 0.0723314,  1420,     5,  15342,   4359,  19701
158466,21182, 0.0382409, 0.0793651, 0.0393131,   180,    10,   4707,    126,   4833
158467,21189, 0.2334767, 0.0091764, 0.1838485,  3582,    40,  15342,   4359,  19701
158468,21189, 0.2983314, 0.0291351, 0.2387696,  4577,   127,  15342,   4359,  19701
158469,21154, 0.0262620, 0.1771541, 0.0594654,  1466,  2790,  55822,  15749,  71571
158470,21154, 0.0000000, 0.1434377, 0.0315631,     0,  2259,  55822,  15749,  71571
158471,21154, 0.0599405, 0.0005080, 0.0468626,  3346,     8,  55822,  15749,  71571
158472,21154, 0.1247537, 0.0208267, 0.1018848,  6964,   328,  55822,  15749,  71571
159444,15082, 0.0000000, 0.0199683, 0.0120573,     0,   857,  28159,  42918,  71077
159445,15082, 0.3829326, 0.0583438, 0.1869381, 10783,  2504,  28159,  42918,  71077
159447,15082, 0.0000000, 0.0044037, 0.0026591,     0,   189,  28159,  42918,  71077
159448,15082, 0.0000000, 0.0013048, 0.0007879,     0,    56,  28159,  42918,  71077
159449,15082, 0.0000000, 0.0050795, 0.0030671,     0,   218,  28159,  42918,  71077
159450,15082, 0.0000000, 0.0009553, 0.0005768,     0,    41,  28159,  42918,  71077
159451,15097, 0.0000000, 0.0041378, 0.0035078,     0,    61,   2648,  14742,  17390
159452,15097, 0.3987916, 0.1040564, 0.1489362,  1056,  1534,   2648,  14742,  17390
159453,15097, 0.0339879, 0.1818614, 0.1593444,    90,  2681,   2648,  14742,  17390
159454,15004, 0.0000000, 0.0141844, 0.0111739,     0,   166,   3153,  11703,  14856
159455,15021, 0.0000000, 0.0343553, 0.0277547,     0,  1004,   6950,  29224,  36174
159456,15021, 0.0000000, 0.0455448, 0.0367944,     0,  1331,   6950,  29224,  36174
159457,15021, 0.0000000, 0.0246373, 0.0199038,     0,   720,   6950,  29224,  36174
159458,15021, 0.3923741, 0.1426909, 0.1906618,  2727,  4170,   6950,  29224,  36174
159459,15021, 0.2776978, 0.0358609, 0.0823243,  1930,  1048,   6950,  29224,  36174
159460,15040, 0.0000000, 0.0872272, 0.0413524,     0,  1387,  17640,  15901,  33541
159460,15021, 0.0000000, 0.0130030, 0.0105048,     0,   380,   6950,  29224,  36174
159460,15113, 0.0000000, 0.0292498, 0.0209865,     0,  1259,  16948,  43043,  59991
159461,15113, 0.0000000, 0.0483005, 0.0346552,     0,  2079,  16948,  43043,  59991
159463,15113, 0.0000000, 0.0159143, 0.0114184,     0,   685,  16948,  43043,  59991
159464,15119, 0.0000000, 0.1079698, 0.0812099,     0,  1329,   4056,  12309,  16365
159465,15088, 0.0000000, 0.0412373, 0.0214303,     0,  1949,  43683,  47263,  90946
159466,15052, 0.0000000, 0.0146766, 0.0100687,     0,   258,   8045,  17579,  25624
159466,15088, 0.0000000, 0.0218353, 0.0113474,     0,  1032,  43683,  47263,  90946
159467,15052, 0.0000000, 0.0401047, 0.0275133,     0,   705,   8045,  17579,  25624
159468,15052, 0.0000000, 0.1075146, 0.0737590,     0,  1890,   8045,  17579,  25624
159469,15052, 0.0000000, 0.0610387, 0.0418748,     0,  1073,   8045,  17579,  25624
159469,15063, 0.0000000, 0.0177929, 0.0150929,     0,   480,   4826,  26977,  31803
159470,15052, 0.0000000, 0.0081347, 0.0055807,     0,   143,   8045,  17579,  25624
159475,17018, 0.0000000, 0.0104780, 0.0006751,     0,    73, 101159,   6967, 108126
159476,17018, 0.0000000, 0.0038754, 0.0002497,     0,    27, 101159,   6967, 108126
159476,17007, 0.0000000, 0.0008499, 0.0000329,     0,    12, 351048,  14120, 365168
159477,17007, 0.1034474, 0.0968839, 0.1031936, 36315,  1368, 351048,  14120, 365168
159480,17011, 0.1993134, 0.1570902, 0.1977426, 37795,  1151, 189626,   7327, 196953
159480,17020, 0.0000000, 0.0960401, 0.0456172,     0,  1899,  21856,  19773,  41629
159481,17011, 0.0068345, 0.0109185, 0.0069864,  1296,    80, 189626,   7327, 196953
159481,17029, 0.0639976, 0.0084436, 0.0545146,  5192,   141,  81128,  16699,  97827
159481,17020, 0.1466417, 0.0012644, 0.0775901,  3205,    25,  21856,  19773,  41629
159482,17029, 0.0000000, 0.0093419, 0.0015947,     0,   156,  81128,  16699,  97827
159483,17029, 0.1592175, 0.0359303, 0.1381725, 12917,   600,  81128,  16699,  97827
159484,17029, 0.0680160, 0.1261153, 0.0779335,  5518,  2106,  81128,  16699,  97827
159485,17029, 0.0093802, 0.0213785, 0.0114283,   761,   357,  81128,  16699,  97827
159486,17029, 0.0690021, 0.0240134, 0.0613225,  5598,   401,  81128,  16699,  97827
159486,17026, 0.0000000, 0.0396306, 0.0204921,     0,   339,   7989,   8554,  16543
159487,17029, 0.0209176, 0.0395233, 0.0240936,  1697,   660,  81128,  16699,  97827
159488,17002, 0.0191423, 0.1031804, 0.0557820,   204,   850,  10657,   8238,  18895
159489,17030, 0.0000622, 0.0388767, 0.0121985,     2,   569,  32173,  14636,  46809
159489,17002, 0.0000000, 0.1669094, 0.0727706,     0,  1375,  10657,   8238,  18895
159490,17030, 0.1279023, 0.0201558, 0.0942127,  4115,   295,  32173,  14636,  46809
159492,17030, 0.0405309, 0.0000683, 0.0278793,  1304,     1,  32173,  14636,  46809
159493,17016, 0.1585296, 0.0065007, 0.0850042,  1380,    53,   8705,   8153,  16858
159494,17016, 0.0096496, 0.2606403, 0.1310357,    84,  2125,   8705,   8153,  16858
159495,17022, 0.5901541, 0.1816335, 0.5376215,  9842,   447,  16677,   2461,  19138
159497,21188, 0.0000000, 0.1614757, 0.0825112,     0,  1405,   8327,   8701,  17028
159497,17022, 0.0890448, 0.0040634, 0.0781168,  1485,    10,  16677,   2461,  19138
159499,21188, 0.0000000, 0.3195035, 0.1632605,     0,  2780,   8327,   8701,  17028
159500,21188, 0.3343341, 0.0928629, 0.2109467,  2784,   808,   8327,   8701,  17028
159501,21188, 0.0768584, 0.0271233, 0.0514447,   640,   236,   8327,   8701,  17028
159502,21019, 0.0548490, 0.0034919, 0.0438526,  5477,    95,  99856,  27206, 127062
159503,21019, 0.0000000, 0.0003676, 0.0000787,     0,    10,  99856,  27206, 127062
159504,21019, 0.0049471, 0.0115783, 0.0063670,   494,   315,  99856,  27206, 127062
159505,21019, 0.1705856, 0.0035654, 0.1348239, 17034,    97,  99856,  27206, 127062
159506,21019, 0.0061489, 0.2133353, 0.0505108,   614,  5804,  99856,  27206, 127062
159507,21019, 0.0000000, 0.0864883, 0.0185185,     0,  2353,  99856,  27206, 127062
159508,21019, 0.0000000, 0.0594354, 0.0127261,     0,  1617,  99856,  27206, 127062
159509,21106, 0.0000000, 0.0428288, 0.0125972,     0,   324,  18155,   7565,  25720
159511,21114, 0.0015386, 0.0006579, 0.0015203,  2320,    21,1507901,  31918,1539819
159513,21114, 0.0000000, 0.0306410, 0.0006351,     0,   978,1507901,  31918,1539819
159514,21114, 0.0000000, 0.0208973, 0.0004332,     0,   667,1507901,  31918,1539819
159515,21114, 0.0000000, 0.0702738, 0.0014567,     0,  2243,1507901,  31918,1539819
159517,21193, 0.0000000, 0.1609650, 0.1304069,     0,   814,   1185,   5057,   6242
159519,21193, 0.0000000, 0.0314416, 0.0254726,     0,   159,   1185,   5057,   6242
159520,21153, 0.0000000, 0.0001861, 0.0000987,     0,     2,   9522,  10745,  20267
159521,21153, 0.0082966, 0.1611913, 0.0893571,    79,  1732,   9522,  10745,  20267
159522,21153, 0.0026255, 0.0531410, 0.0294074,    25,   571,   9522,  10745,  20267
159523,21153, 0.1018694, 0.0019544, 0.0488972,   970,    21,   9522,  10745,  20267
159524,21182, 0.5107287, 0.0634921, 0.4990689,  2404,     8,   4707,    126,   4833
159524,21151, 0.0000000, 0.1632653, 0.0009980,     0,     8,   7967,     49,   8016
159525,21182, 0.1240705, 0.2142857, 0.1264225,   584,    27,   4707,    126,   4833
159525,21151, 0.2054726, 0.5714286, 0.2077096,  1637,    28,   7967,     49,   8016
159526,21189, 0.0261374, 0.2303281, 0.0713162,   401,  1004,  15342,   4359,  19701
159527,21189, 0.2167905, 0.0660702, 0.1834425,  3326,   288,  15342,   4359,  19701
159528,21154, 0.0529719, 0.0088260, 0.0432577,  2957,   139,  55822,  15749,  71571
159529,21154, 0.0273906, 0.0125087, 0.0241159,  1529,   197,  55822,  15749,  71571
159530,21154, 0.2426104, 0.0560671, 0.2015621, 13543,   883,  55822,  15749,  71571
159533,21110, 0.0141311, 0.0120413, 0.0136172,   457,   127,  32340,  10547,  42887
160503,15082, 0.0000000, 0.0318048, 0.0192045,     0,  1365,  28159,  42918,  71077
160504,15082, 0.0000000, 0.0244653, 0.0147727,     0,  1050,  28159,  42918,  71077
160505,15082, 0.0000000, 0.0077823, 0.0046991,     0,   334,  28159,  42918,  71077
160505,15077, 0.0000000, 0.0219048, 0.0183355,     0,   115,   1022,   5250,   6272
160506,15077, 0.0000000, 0.0409524, 0.0342793,     0,   215,   1022,   5250,   6272
160507,15077, 0.0000000, 0.0946667, 0.0792411,     0,   497,   1022,   5250,   6272
160508,15077, 0.0000000, 0.0626667, 0.0524554,     0,   329,   1022,   5250,   6272
160509,15097, 0.0000000, 0.0006783, 0.0005750,     0,    10,   2648,  14742,  17390
160511,15097, 0.5294562, 0.1773843, 0.2309948,  1402,  2615,   2648,  14742,  17390
160512,15097, 0.0377644, 0.0263872, 0.0281196,   100,   389,   2648,  14742,  17390
160513,15097, 0.0000000, 0.1015466, 0.0860840,     0,  1497,   2648,  14742,  17390
160514,15021, 0.0000000, 0.0070490, 0.0056947,     0,   206,   6950,  29224,  36174
160515,15021, 0.0000000, 0.0062962, 0.0050865,     0,   184,   6950,  29224,  36174
160516,15021, 0.0000000, 0.0324733, 0.0262343,     0,   949,   6950,  29224,  36174
160517,15021, 0.2707914, 0.1434095, 0.1678830,  1882,  4191,   6950,  29224,  36174
160519,15113, 0.0000000, 0.0464652, 0.0333383,     0,  2000,  16948,  43043,  59991
160520,15113, 0.0529266, 0.0349883, 0.0400560,   897,  1506,  16948,  43043,  59991
160521,15113, 0.0518055, 0.0741816, 0.0678602,   878,  3193,  16948,  43043,  59991
160522,15113, 0.0447250, 0.1412541, 0.1139838,   758,  6080,  16948,  43043,  59991
160523,15088, 0.0135522, 0.1526352, 0.0858312,   592,  7214,  43683,  47263,  90946
160524,15088, 0.0192523, 0.1241140, 0.0737471,   841,  5866,  43683,  47263,  90946
160525,15088, 0.0000000, 0.0535514, 0.0278297,     0,  2531,  43683,  47263,  90946
160527,15052, 0.8248602, 0.0566585, 0.2978458,  6636,   996,   8045,  17579,  25624
160529,15063, 0.0000000, 0.1612485, 0.1367795,     0,  4350,   4826,  26977,  31803
160529,15052, 0.0000000, 0.1039308, 0.0713003,     0,  1827,   8045,  17579,  25624
160532,15063, 0.0000000, 0.0018534, 0.0015722,     0,    50,   4826,  26977,  31803
160533,17007, 0.0000000, 0.0644476, 0.0024920,     0,   910, 351048,  14120, 365168
160533,15063, 0.0000000, 0.0355859, 0.0301858,     0,   960,   4826,  26977,  31803
160534,17007, 0.0000000, 0.0000708, 0.0000027,     0,     1, 351048,  14120, 365168
160535,17007, 0.0306027, 0.0500708, 0.0313554, 10743,   707, 351048,  14120, 365168
160538,17020, 0.0000000, 0.1351843, 0.0642100,     0,  2673,  21856,  19773,  41629
160538,17007, 0.0810601, 0.0174929, 0.0786022, 28456,   247, 351048,  14120, 365168
160539,17020, 0.0000000, 0.0732818, 0.0348075,     0,  1449,  21856,  19773,  41629
160542,17029, 0.0000000, 0.0443140, 0.0075644,     0,   740,  81128,  16699,  97827
160542,17020, 0.0000000, 0.0069792, 0.0033150,     0,   138,  21856,  19773,  41629
160543,17029, 0.0315797, 0.1224624, 0.0470933,  2562,  2045,  81128,  16699,  97827
160543,17020, 0.0000000, 0.1323522, 0.0628648,     0,  2617,  21856,  19773,  41629
160543,17026, 0.0000000, 0.1162029, 0.0600858,     0,   994,   7989,   8554,  16543
160544,17029, 0.0000000, 0.0706629, 0.0120621,     0,  1180,  81128,  16699,  97827
160544,17026, 0.0000000, 0.1027589, 0.0531343,     0,   879,   7989,   8554,  16543
160545,17029, 0.0354008, 0.0980897, 0.0461018,  2872,  1638,  81128,  16699,  97827
160545,17026, 0.0000000, 0.1187748, 0.0614157,     0,  1016,   7989,   8554,  16543
160546,17029, 0.0078764, 0.0700641, 0.0184918,   639,  1170,  81128,  16699,  97827
160546,17026, 0.0000000, 0.0239654, 0.0123919,     0,   205,   7989,   8554,  16543
160546,17002, 0.0933659, 0.0089828, 0.0565758,   995,    74,  10657,   8238,  18895
160547,17002, 0.0804166, 0.1428745, 0.1076475,   857,  1177,  10657,   8238,  18895
160548,17002, 0.6312283, 0.1494295, 0.4211696,  6727,  1231,  10657,   8238,  18895
160549,17002, 0.0000000, 0.0021850, 0.0009526,     0,    18,  10657,   8238,  18895
160550,17030, 0.0000000, 0.0007516, 0.0002350,     0,    11,  32173,  14636,  46809
160551,17030, 0.0000000, 0.0389451, 0.0121771,     0,   570,  32173,  14636,  46809
160552,17016, 0.3145319, 0.2201644, 0.2688931,  2738,  1795,   8705,   8153,  16858
160552,17030, 0.0000000, 0.0986608, 0.0308488,     0,  1444,  32173,  14636,  46809
160553,17022, 0.0000000, 0.6651767, 0.0855366,     0,  1637,  16677,   2461,  19138
160553,17016, 0.0003446, 0.1655832, 0.0802586,     3,  1350,   8705,   8153,  16858
160556,17022, 0.0000000, 0.0004063, 0.0000523,     0,     1,  16677,   2461,  19138
160558,21188, 0.0116489, 0.0504540, 0.0314776,    97,   439,   8327,   8701,  17028
160559,21188, 0.2374204, 0.0011493, 0.1166902,  1977,    10,   8327,   8701,  17028
160560,21019, 0.0000000, 0.0870396, 0.0186366,     0,  2368,  99856,  27206, 127062
160561,21019, 0.0114665, 0.0001470, 0.0090428,  1145,     4,  99856,  27206, 127062
160562,21019, 0.0006109, 0.0001103, 0.0005037,    61,     3,  99856,  27206, 127062
160563,21019, 0.0844116, 0.0122767, 0.0689663,  8429,   334,  99856,  27206, 127062
160564,21019, 0.3827812, 0.0016540, 0.3011758, 38223,    45,  99856,  27206, 127062
160565,21019, 0.1240586, 0.0660516, 0.1116384, 12388,  1797,  99856,  27206, 127062
160566,21019, 0.0000000, 0.0969272, 0.0207536,     0,  2637,  99856,  27206, 127062
160566,21148, 0.0000000, 0.0216577, 0.0165423,     0,   133,   1899,   6141,   8040
160567,21106, 0.0000000, 0.1201586, 0.0353421,     0,   909,  18155,   7565,  25720
160567,21019, 0.0000000, 0.0235977, 0.0050527,     0,   642,  99856,  27206, 127062
160568,21106, 0.0000000, 0.0426966, 0.0125583,     0,   323,  18155,   7565,  25720
160570,21114, 0.0018960, 0.0201454, 0.0022743,  2859,   643,1507901,  31918,1539819
160571,21114, 0.0019696, 0.0090545, 0.0021165,  2970,   289,1507901,  31918,1539819
160572,21114, 0.0000000, 0.0234977, 0.0004871,     0,   750,1507901,  31918,1539819
160573,21114, 0.0024425, 0.0810201, 0.0040713,  3683,  2586,1507901,  31918,1539819
160574,21114, 0.0000000, 0.0016292, 0.0000338,     0,    52,1507901,  31918,1539819
160575,21193, 0.0000000, 0.1534507, 0.1243191,     0,   776,   1185,   5057,   6242
160575,21114, 0.0000000, 0.0113729, 0.0002357,     0,   363,1507901,  31918,1539819
160576,21040, 0.0000000, 0.0005647, 0.0004194,     0,     4,   2454,   7084,   9538
160576,21114, 0.0000000, 0.0151325, 0.0003137,     0,   483,1507901,  31918,1539819
160578,21153, 0.0000000, 0.1502094, 0.0796368,     0,  1614,   9522,  10745,  20267
160580,21153, 0.3773367, 0.0009307, 0.1777767,  3593,    10,   9522,  10745,  20267
160581,21153, 0.1473430, 0.0107027, 0.0749001,  1403,   115,   9522,  10745,  20267
160582,21153, 0.0000000, 0.1342950, 0.0711995,     0,  1443,   9522,  10745,  20267
160583,21097, 0.9993075, 1.0000000, 0.9995487,  1443,   772,   1444,    772,   2216
160584,21151, 0.4395632, 0.0816327, 0.4373752,  3502,     4,   7967,     49,   8016
160585,21151, 0.1364378, 0.1836735, 0.1367265,  1087,     9,   7967,     49,   8016
160585,21038, 0.1340524, 0.1515924, 0.1372144,   957,   238,   7139,   1570,   8709
160586,21189, 0.0787381, 0.0126176, 0.0641084,  1208,    55,  15342,   4359,  19701
160586,21038, 0.2477938, 0.0050955, 0.2040418,  1769,     8,   7139,   1570,   8709
160587,21144, 0.1411755, 0.1249103, 0.1395023,  1715,   174,  12148,   1393,  13541
160587,21038, 0.0000000, 0.0503185, 0.0090711,     0,    79,   7139,   1570,   8709
160588,21154, 0.1564258, 0.0174614, 0.1258471,  8732,   275,  55822,  15749,  71571
160588,21144, 0.0135825, 0.0028715, 0.0124806,   165,     4,  12148,   1393,  13541
160589,21154, 0.1592741, 0.0140961, 0.1273281,  8891,   222,  55822,  15749,  71571
160591,21110, 0.0000000, 0.0201953, 0.0049665,     0,   213,  32340,  10547,  42887
160591,21154, 0.0000000, 0.0201283, 0.0044292,     0,   317,  55822,  15749,  71571
160592,21110, 0.0060606, 0.0408647, 0.0146198,   196,   431,  32340,  10547,  42887
161562,15082, 0.0000000, 0.0178247, 0.0107630,     0,   765,  28159,  42918,  71077
161563,15082, 0.0000000, 0.0014446, 0.0008723,     0,    62,  28159,  42918,  71077
161564,15082, 0.0000000, 0.0201081, 0.0121418,     0,   863,  28159,  42918,  71077
161565,15082, 0.0000000, 0.0320611, 0.0193593,     0,  1376,  28159,  42918,  71077
161566,15077, 0.0000000, 0.2657143, 0.2224171,     0,  1395,   1022,   5250,   6272
161567,15077, 0.0000000, 0.0219048, 0.0183355,     0,   115,   1022,   5250,   6272
161568,15077, 0.0000000, 0.0323810, 0.0271046,     0,   170,   1022,   5250,   6272
161570,15097, 0.0000000, 0.0683761, 0.0579643,     0,  1008,   2648,  14742,  17390
161571,15097, 0.0000000, 0.0804504, 0.0682001,     0,  1186,   2648,  14742,  17390
161572,15097, 0.0000000, 0.1128748, 0.0956872,     0,  1664,   2648,  14742,  17390
161574,15021, 0.0000000, 0.0217629, 0.0175817,     0,   636,   6950,  29224,  36174
161575,15021, 0.0000000, 0.0094443, 0.0076298,     0,   276,   6950,  29224,  36174
161576,15021, 0.0000000, 0.1179852, 0.0953171,     0,  3448,   6950,  29224,  36174
161577,15021, 0.0000000, 0.0531070, 0.0429037,     0,  1552,   6950,  29224,  36174
161577,15113, 0.0000000, 0.0026485, 0.0019003,     0,   114,  16948,  43043,  59991
161578,15113, 0.0618952, 0.0180053, 0.0304046,  1049,   775,  16948,  43043,  59991
161579,15113, 0.0923413, 0.0700462, 0.0763448,  1565,  3015,  16948,  43043,  59991
161580,15113, 0.1054992, 0.0808726, 0.0878298,  1788,  3481,  16948,  43043,  59991
161581,15113, 0.5163441, 0.0174012, 0.1583571,  8751,   749,  16948,  43043,  59991
161582,15088, 0.2540348, 0.0650826, 0.1558397, 11097,  3076,  43683,  47263,  90946
161583,15088, 0.3890987, 0.2388126, 0.3109977, 16997, 11287,  43683,  47263,  90946
161584,15088, 0.0000000, 0.0939636, 0.0488312,     0,  4441,  43683,  47263,  90946
161585,15088, 0.0325985, 0.0267440, 0.0295560,  1424,  1264,  43683,  47263,  90946
161586,15052, 0.1751398, 0.0740656, 0.1057993,  1409,  1302,   8045,  17579,  25624
161587,15063, 0.0000000, 0.0085999, 0.0072949,     0,   232,   4826,  26977,  31803
161588,15063, 0.0010361, 0.0123809, 0.0106594,     5,   334,   4826,  26977,  31803
161589,15063, 0.0917944, 0.0102680, 0.0226394,   443,   277,   4826,  26977,  31803
161591,15063, 0.0000000, 0.0038922, 0.0033016,     0,   105,   4826,  26977,  31803
161592,15063, 0.0000000, 0.0078215, 0.0066346,     0,   211,   4826,  26977,  31803
161593,17007, 0.0020453, 0.0121813, 0.0024372,   718,   172, 351048,  14120, 365168
161594,17007, 0.0616070, 0.0104108, 0.0596274, 21627,   147, 351048,  14120, 365168
161596,17007, 0.0993653, 0.0376771, 0.0969800, 34882,   532, 351048,  14120, 365168
161597,17007, 0.0144767, 0.5250000, 0.0342171,  5082,  7413, 351048,  14120, 365168
161597,17020, 0.0000000, 0.0205330, 0.0097528,     0,   406,  21856,  19773,  41629
161599,17020, 0.0015556, 0.0702473, 0.0341829,    34,  1389,  21856,  19773,  41629
161600,17020, 0.0000000, 0.0005057, 0.0002402,     0,    10,  21856,  19773,  41629
161601,17020, 0.0000000, 0.1054468, 0.0500853,     0,  2085,  21856,  19773,  41629
161604,17026, 0.9991238, 0.1076689, 0.5381733,  7982,   921,   7989,   8554,  16543
161605,17026, 0.0000000, 0.0222118, 0.0114852,     0,   190,   7989,   8554,  16543
161606,17002, 0.0000000, 0.0036417, 0.0015877,     0,    30,  10657,   8238,  18895
161606,17027, 0.0000000, 0.0017425, 0.0007415,     0,     8,   6198,   4591,  10789
161607,17002, 0.1139157, 0.2574654, 0.1765017,  1214,  2121,  10657,   8238,  18895
161608,17002, 0.0000000, 0.0679777, 0.0296375,     0,   560,  10657,   8238,  18895
161609,17030, 0.0000000, 0.1568735, 0.0490504,     0,  2296,  32173,  14636,  46809
161609,15094, 0.0000000, 0.0473951, 0.0071479,     0,   131,  15563,   2764,  18327
161609,15068, 0.0000000, 0.0017083, 0.0004778,     0,    13,  19597,   7610,  27207
161611,15034, 0.0000000, 0.5209866, 0.1285089,     0,  1204,   7058,   2311,   9369
161613,15034, 0.0519977, 0.0090870, 0.0414132,   367,    21,   7058,   2311,   9369
161619,21188, 0.0000000, 0.0028732, 0.0014682,     0,    25,   8327,   8701,  17028
161619,21019, 0.0289116, 0.0303242, 0.0292141,  2887,   825,  99856,  27206, 127062
161620,21019, 0.0000000, 0.0005513, 0.0001181,     0,    15,  99856,  27206, 127062
161622,21019, 0.0611280, 0.0142248, 0.0510853,  6104,   387,  99856,  27206, 127062
161622,21175, 0.0000000, 0.1387446, 0.0653615,     0,   641,   5187,   4620,   9807
161623,21019, 0.0010615, 0.0835477, 0.0187231,   106,  2273,  99856,  27206, 127062
161624,21019, 0.0339589, 0.0117621, 0.0292062,  3391,   320,  99856,  27206, 127062
161625,21019, 0.0000000, 0.0439609, 0.0094127,     0,  1196,  99856,  27206, 127062
161626,21106, 0.0000000, 0.0395241, 0.0116252,     0,   299,  18155,   7565,  25720
161627,21106, 0.0124484, 0.0050231, 0.0102644,   226,    38,  18155,   7565,  25720
161628,21106, 0.1899201, 0.0793126, 0.1573873,  3448,   600,  18155,   7565,  25720
161629,21114, 0.0002520, 0.0406667, 0.0010897,   380,  1298,1507901,  31918,1539819
161630,21114, 0.0084535, 0.0172630, 0.0086361, 12747,   551,1507901,  31918,1539819
161632,21114, 0.0002261, 0.0022558, 0.0002682,   341,    72,1507901,  31918,1539819
161633,21114, 0.0023529, 0.0006893, 0.0023185,  3548,    22,1507901,  31918,1539819
161634,21114, 0.0000000, 0.0016918, 0.0000351,     0,    54,1507901,  31918,1539819
161634,21040, 0.0000000, 0.0086110, 0.0063955,     0,    61,   2454,   7084,   9538
161635,21040, 0.0000000, 0.1760305, 0.1307402,     0,  1247,   2454,   7084,   9538
161636,21040, 0.0000000, 0.0731225, 0.0543091,     0,   518,   2454,   7084,   9538
161637,21040, 0.0000000, 0.1055901, 0.0784231,     0,   748,   2454,   7084,   9538
161638,21040, 0.0000000, 0.3595426, 0.2670371,     0,  2547,   2454,   7084,   9538
161639,21040, 0.0000000, 0.0019763, 0.0014678,     0,    14,   2454,   7084,   9538
161639,21153, 0.0000000, 0.0055840, 0.0029605,     0,    60,   9522,  10745,  20267
161640,21153, 0.0000000, 0.0294090, 0.0155918,     0,   316,   9522,  10745,  20267
161641,21164, 0.0002536, 0.0025587, 0.0009771,    13,    60,  51259,  23449,  74708
161641,21153, 0.0000000, 0.2228944, 0.1181724,     0,  2395,   9522,  10745,  20267
161643,21038, 0.0000000, 0.0216561, 0.0039040,     0,    34,   7139,   1570,   8709
161643,21164, 0.1386098, 0.0048616, 0.0966295,  7105,   114,  51259,  23449,  74708
161644,21038, 0.3024233, 0.1070064, 0.2671949,  2159,   168,   7139,   1570,   8709
161644,21118, 0.0127968, 0.0085324, 0.0124056,   297,    20,  23209,   2344,  25553
161645,21038, 0.3157305, 0.0089172, 0.2604203,  2254,    14,   7139,   1570,   8709
161645,21118, 0.0807876, 0.0191980, 0.0751380,  1875,    45,  23209,   2344,  25553
161646,21144, 0.6726210, 0.5735822, 0.6624326,  8171,   799,  12148,   1393,  13541
161646,21038, 0.0000000, 0.0044586, 0.0008038,     0,     7,   7139,   1570,   8709
161647,21144, 0.1727033, 0.2921752, 0.1849937,  2098,   407,  12148,   1393,  13541
161648,21154, 0.0820465, 0.1500413, 0.0970086,  4580,  2363,  55822,  15749,  71571
161649,21115, 0.0000000, 0.0950570, 0.0179776,     0,   850,  38339,   8942,  47281
161650,21115, 0.0196927, 0.0265041, 0.0209809,   755,   237,  38339,   8942,  47281
161651,21115, 0.0755888, 0.1205547, 0.0840930,  2898,  1078,  38339,   8942,  47281
162621,15086, 0.0000000, 0.0092956, 0.0085793,     0,   282,   2533,  30337,  32870
162625,15077, 0.0000000, 0.0320000, 0.0267857,     0,   168,   1022,   5250,   6272
162626,15077, 0.0000000, 0.1047619, 0.0876913,     0,   550,   1022,   5250,   6272
162627,15077, 0.0000000, 0.0285714, 0.0239158,     0,   150,   1022,   5250,   6272
162628,15077, 0.0000000, 0.0285714, 0.0239158,     0,   150,   1022,   5250,   6272
162629,15086, 0.0000000, 0.0029337, 0.0027076,     0,    89,   2533,  30337,  32870
162630,15097, 0.0000000, 0.0191290, 0.0162162,     0,   282,   2648,  14742,  17390
162630,15086, 0.0000000, 0.0157234, 0.0145117,     0,   477,   2533,  30337,  32870
162632,15021, 0.0000000, 0.0298043, 0.0240781,     0,   871,   6950,  29224,  36174
162632,15086, 0.0000000, 0.0140093, 0.0129297,     0,   425,   2533,  30337,  32870
162633,15021, 0.0000000, 0.0250821, 0.0202632,     0,   733,   6950,  29224,  36174
162634,15021, 0.0000000, 0.0054407, 0.0043954,     0,   159,   6950,  29224,  36174
162635,15021, 0.0000000, 0.0585478, 0.0472992,     0,  1711,   6950,  29224,  36174
162636,15021, 0.0000000, 0.0088284, 0.0071322,     0,   258,   6950,  29224,  36174
162637,15113, 0.0102667, 0.0006737, 0.0033838,   174,    29,  16948,  43043,  59991
162639,15113, 0.0208874, 0.1529168, 0.1156173,   354,  6582,  16948,  43043,  59991
162640,15113, 0.0000000, 0.0143345, 0.0102849,     0,   617,  16948,  43043,  59991
162640,15088, 0.0000000, 0.0165246, 0.0085875,     0,   781,  43683,  47263,  90946
162641,15088, 0.0000000, 0.0040412, 0.0021001,     0,   191,  43683,  47263,  90946
162642,15088, 0.0655862, 0.0270190, 0.0455435,  2865,  1277,  43683,  47263,  90946
162643,15088, 0.0010301, 0.0429088, 0.0227937,    45,  2028,  43683,  47263,  90946
162645,15052, 0.0000000, 0.1956880, 0.1342491,     0,  3440,   8045,  17579,  25624
162646,15063, 0.0000000, 0.0089706, 0.0076093,     0,   242,   4826,  26977,  31803
162646,15052, 0.0000000, 0.0077934, 0.0053466,     0,   137,   8045,  17579,  25624
162647,15063, 0.4227103, 0.0987508, 0.1479106,  2040,  2664,   4826,  26977,  31803
162648,15063, 0.4842520, 0.1499055, 0.2006415,  2337,  4044,   4826,  26977,  31803
162649,15063, 0.0000000, 0.0195722, 0.0166022,     0,   528,   4826,  26977,  31803
162650,15063, 0.0000000, 0.0016681, 0.0014150,     0,    45,   4826,  26977,  31803
162651,15063, 0.0000000, 0.0080439, 0.0068233,     0,   217,   4826,  26977,  31803
162652,17007, 0.0008204, 0.0004249, 0.0008051,   288,     6, 351048,  14120, 365168
162653,17007, 0.0306112, 0.0325779, 0.0306872, 10746,   460, 351048,  14120, 365168
162654,17007, 0.0460507, 0.0072946, 0.0445521, 16166,   103, 351048,  14120, 365168
162655,17007, 0.0089532, 0.0454674, 0.0103651,  3143,   642, 351048,  14120, 365168
162656,17020, 0.0000000, 0.0020735, 0.0009849,     0,    41,  21856,  19773,  41629
162656,17007, 0.0099274, 0.0991501, 0.0133774,  3485,  1400, 351048,  14120, 365168
162657,17020, 0.1284773, 0.0033379, 0.0690384,  2808,    66,  21856,  19773,  41629
162658,17020, 0.0905472, 0.0289789, 0.0613034,  1979,   573,  21856,  19773,  41629
162659,17020, 0.5341783, 0.0051585, 0.2829038, 11675,   102,  21856,  19773,  41629
162660,17020, 0.0161969, 0.0754059, 0.0443201,   354,  1491,  21856,  19773,  41629
162661,17020, 0.0000000, 0.0558337, 0.0265200,     0,  1104,  21856,  19773,  41629
162662,17026, 0.0000000, 0.1614449, 0.0834794,     0,  1381,   7989,   8554,  16543
162663,17026, 0.0000000, 0.0992518, 0.0513208,     0,   849,   7989,   8554,  16543
162663,17027, 0.0000000, 0.1102156, 0.0468996,     0,   506,   6198,   4591,  10789
162664,17026, 0.0000000, 0.2073884, 0.1072357,     0,  1774,   7989,   8554,  16543
162664,17027, 0.0000000, 0.0801568, 0.0341088,     0,   368,   6198,   4591,  10789
162665,17027, 1.0000000, 0.0890873, 0.6123829,  6198,   409,   6198,   4591,  10789
162665,17026, 0.0000000, 0.0007014, 0.0003627,     0,     6,   7989,   8554,  16543
162666,17002, 0.0000000, 0.0513474, 0.0223869,     0,   423,  10657,   8238,  18895
162666,17027, 0.0000000, 0.0261381, 0.0111224,     0,   120,   6198,   4591,  10789
162667,17002, 0.0000000, 0.0460063, 0.0200582,     0,   379,  10657,   8238,  18895
162667,15094, 0.0195978, 0.0459479, 0.0235718,   305,   127,  15563,   2764,  18327
162668,15068, 0.0000000, 0.0144547, 0.0040431,     0,   110,  19597,   7610,  27207
162668,15094, 0.1224700, 0.0206223, 0.1071097,  1906,    57,  15563,   2764,  18327
162669,15068, 0.0000000, 0.3591327, 0.1004521,     0,  2733,  19597,   7610,  27207
162669,15015, 0.0685682, 0.0120030, 0.0631168,  1714,    32,  24997,   2666,  27663
162670,15015, 0.1234948, 0.0090023, 0.1124607,  3087,    24,  24997,   2666,  27663
162671,15034, 0.3060357, 0.4491562, 0.3413385,  2160,  1038,   7058,   2311,   9369
162680,21175, 0.0000000, 0.0127706, 0.0060161,     0,    59,   5187,   4620,   9807
162681,21175, 0.1897050, 0.4939394, 0.3330274,   984,  2282,   5187,   4620,   9807
162682,21175, 0.7927511, 0.1155844, 0.4737432,  4112,   534,   5187,   4620,   9807
162683,21148, 0.0000000, 0.3391956, 0.2590796,     0,  2083,   1899,   6141,   8040
162684,21148, 0.0000000, 0.2916463, 0.2227612,     0,  1791,   1899,   6141,   8040
162685,21106, 0.1516387, 0.0235294, 0.1139580,  2753,   178,  18155,   7565,  25720
162685,21148, 0.0000000, 0.3364273, 0.2569652,     0,  2066,   1899,   6141,   8040
162686,21106, 0.1716882, 0.1710509, 0.1715008,  3117,  1294,  18155,   7565,  25720
162687,21106, 0.1773616, 0.1557171, 0.1709953,  3220,  1178,  18155,   7565,  25720
162688,21106, 0.0000000, 0.0253800, 0.0074650,     0,   192,  18155,   7565,  25720
162689,21114, 0.0426971, 0.0001567, 0.0418153, 64383,     5,1507901,  31918,1539819
162690,21114, 0.0195053, 0.0289492, 0.0197010, 29412,   924,1507901,  31918,1539819
162691,21114, 0.0153041, 0.0775111, 0.0165935, 23077,  2474,1507901,  31918,1539819
162692,21114, 0.0065747, 0.1352528, 0.0092420,  9914,  4317,1507901,  31918,1539819
162694,21040, 0.0000000, 0.0004235, 0.0003145,     0,     3,   2454,   7084,   9538
162695,21040, 0.0000000, 0.0112931, 0.0083875,     0,    80,   2454,   7084,   9538
162696,21040, 0.0484923, 0.0009881, 0.0132103,   119,     7,   2454,   7084,   9538
162697,21040, 0.9515077, 0.0028233, 0.2469071,  2335,    20,   2454,   7084,   9538
162698,21040, 0.0000000, 0.1185771, 0.0880688,     0,   840,   2454,   7084,   9538
162699,21153, 0.0000000, 0.1285249, 0.0681403,     0,  1381,   9522,  10745,  20267
162699,21040, 0.0000000, 0.0283738, 0.0210736,     0,   201,   2454,   7084,   9538
162700,21164, 0.1135215, 0.0036675, 0.0790411,  5819,    86,  51259,  23449,  74708
162701,21164, 0.2767514, 0.0020470, 0.1905285, 14186,    48,  51259,  23449,  74708
162702,21164, 0.0675199, 0.0478485, 0.0613455,  3461,  1122,  51259,  23449,  74708
162703,21164, 0.0000000, 0.0011514, 0.0003614,     0,    27,  51259,  23449,  74708
162703,21118, 0.0740230, 0.8071672, 0.1412750,  1718,  1892,  23209,   2344,  25553
162703,21038, 0.0000000, 0.6509554, 0.1173499,     0,  1022,   7139,   1570,   8709
162704,21118, 0.5963204, 0.0878840, 0.5496810, 13840,   206,  23209,   2344,  25553
162705,21144, 0.0000000, 0.0043073, 0.0004431,     0,     6,  12148,   1393,  13541
162705,21004, 0.0527817, 0.0011806, 0.0435501,  2257,    11,  42761,   9317,  52078
162706,21144, 0.0000000, 0.0021536, 0.0002215,     0,     3,  12148,   1393,  13541
162706,21154, 0.0000000, 0.0003175, 0.0000699,     0,     5,  55822,  15749,  71571
162706,21004, 0.0000000, 0.2158420, 0.0386152,     0,  2011,  42761,   9317,  52078
162707,21154, 0.0000000, 0.0082545, 0.0018164,     0,   130,  55822,  15749,  71571
162707,21115, 0.0233444, 0.0053679, 0.0199446,   895,    48,  38339,   8942,  47281
162708,21115, 0.0158324, 0.0012301, 0.0130708,   607,    11,  38339,   8942,  47281
162709,21115, 0.2079084, 0.0591590, 0.1797762,  7971,   529,  38339,   8942,  47281
162710,21115, 0.0311954, 0.0107359, 0.0273260,  1196,    96,  38339,   8942,  47281
163681,15086, 0.0000000, 0.0156904, 0.0144813,     0,   476,   2533,  30337,  32870
163682,15082, 0.0000000, 0.0019106, 0.0011537,     0,    82,  28159,  42918,  71077
163683,15086, 0.0000000, 0.0111745, 0.0103134,     0,   339,   2533,  30337,  32870
163685,15077, 0.0000000, 0.0297143, 0.0248724,     0,   156,   1022,   5250,   6272
163685,15086, 0.0000000, 0.0117678, 0.0108610,     0,   357,   2533,  30337,  32870
163686,15077, 1.0000000, 0.2361905, 0.3606505,  1022,  1240,   1022,   5250,   6272
163687,15086, 0.0000000, 0.0462142, 0.0426529,     0,  1402,   2533,  30337,  32870
163688,15086, 0.0000000, 0.0462801, 0.0427137,     0,  1404,   2533,  30337,  32870
163689,15086, 0.0000000, 0.0136137, 0.0125646,     0,   413,   2533,  30337,  32870
163690,15086, 0.0000000, 0.0149652, 0.0138120,     0,   454,   2533,  30337,  32870
163692,15021, 0.0000000, 0.0171092, 0.0138221,     0,   500,   6950,  29224,  36174
163697,15113, 0.0000000, 0.0035314, 0.0025337,     0,   152,  16948,  43043,  59991
163698,15113, 0.0000000, 0.1305671, 0.0936807,     0,  5620,  16948,  43043,  59991
163699,15113, 0.0000000, 0.0030202, 0.0021670,     0,   130,  16948,  43043,  59991
163701,15088, 0.0000000, 0.0036392, 0.0018912,     0,   172,  43683,  47263,  90946
163701,15090, 0.0186599, 0.0239974, 0.0197011,  1171,   365,  62755,  15210,  77965
163702,15088, 0.0639379, 0.0478810, 0.0555934,  2793,  2263,  43683,  47263,  90946
163702,15049, 0.0000000, 0.2745481, 0.0875389,     0,  1124,   8746,   4094,  12840
163703,15088, 0.0159788, 0.0035334, 0.0095111,   698,   167,  43683,  47263,  90946
163704,15088, 0.0000000, 0.0109599, 0.0056957,     0,   518,  43683,  47263,  90946
163704,15049, 0.0000000, 0.3634587, 0.1158879,     0,  1488,   8746,   4094,  12840
163705,15063, 0.0000000, 0.1016421, 0.0862183,     0,  2742,   4826,  26977,  31803
163707,15063, 0.0000000, 0.0399229, 0.0338647,     0,  1077,   4826,  26977,  31803
163708,15063, 0.0000000, 0.1371909, 0.1163727,     0,  3701,   4826,  26977,  31803
163712,17009, 0.1437360, 0.1427707, 0.1433679,  1542,   944,  10728,   6612,  17340
163713,17009, 0.0000000, 0.3310647, 0.1262399,     0,  2189,  10728,   6612,  17340
163716,17020, 0.0000000, 0.0002023, 0.0000961,     0,     4,  21856,  19773,  41629
163717,17020, 0.0044839, 0.0111769, 0.0076629,    98,   221,  21856,  19773,  41629
163718,17020, 0.0021962, 0.0955849, 0.0465541,    48,  1890,  21856,  19773,  41629
163719,17020, 0.0000000, 0.0804127, 0.0381945,     0,  1590,  21856,  19773,  41629
163721,17023, 0.9741735, 0.0039797, 0.5700723,  3772,    11,   3872,   2764,   6636
163722,17023, 0.0258264, 0.1866860, 0.0928270,   100,   516,   3872,   2764,   6636
163723,17027, 0.0000000, 0.4772381, 0.2030772,     0,  2191,   6198,   4591,  10789
163723,17023, 0.0000000, 0.3010130, 0.1253767,     0,   832,   3872,   2764,   6636
163724,17027, 0.0000000, 0.1376606, 0.0585782,     0,   632,   6198,   4591,  10789
163727,15094, 0.0153569, 0.7000723, 0.1186228,   239,  1935,  15563,   2764,  18327
163728,15068, 0.0000000, 0.2758213, 0.0771493,     0,  2099,  19597,   7610,  27207
163728,15094, 0.0091885, 0.0054269, 0.0086212,   143,    15,  15563,   2764,  18327
163729,15015, 0.0132016, 0.0157539, 0.0134476,   330,    42,  24997,   2666,  27663
163730,15034, 0.0000000, 0.0207702, 0.0051233,     0,    48,   7058,   2311,   9369
163730,15015, 0.0000000, 0.0045011, 0.0004338,     0,    12,  24997,   2666,  27663
163739,21175, 0.0000000, 0.2389610, 0.1125727,     0,  1104,   5187,   4620,   9807
163742,21126, 0.1385957, 0.0013710, 0.0526948,   302,     5,   2179,   3647,   5826
163743,21148, 1.0000000, 0.0110731, 0.2446517,  1899,    68,   1899,   6141,   8040
163743,21125, 0.0000000, 0.0334448, 0.0012240,     0,    10,   7871,    299,   8170
163743,21126, 0.0000000, 0.0312586, 0.0195675,     0,   114,   2179,   3647,   5826
163744,21106, 0.0264941, 0.0171844, 0.0237558,   481,   130,  18155,   7565,  25720
163744,21125, 0.1175200, 0.2374582, 0.1219094,   925,    71,   7871,    299,   8170
163745,21106, 0.2389975, 0.2175810, 0.2326983,  4339,  1646,  18155,   7565,  25720
163745,21119, 0.0000705, 0.1333333, 0.0015034,     7,   144,  99359,   1080, 100439
163746,21106, 0.0314514, 0.0600132, 0.0398523,   571,   454,  18155,   7565,  25720
163746,21119, 0.0465282, 0.0879630, 0.0469738,  4623,    95,  99359,   1080, 100439
163750,21114, 0.0230625, 0.0207093, 0.0230137, 34776,   661,1507901,  31918,1539819
163751,21114, 0.0026003, 0.0139420, 0.0028354,  3921,   445,1507901,  31918,1539819
163752,21040, 0.0000000, 0.0057877, 0.0042986,     0,    41,   2454,   7084,   9538
163752,21015, 0.0000000, 0.0220480, 0.0008914,     0,    90,  96882,   4082, 100964
163753,21040, 0.0000000, 0.1038961, 0.0771650,     0,   736,   2454,   7084,   9538
163753,21015, 0.0000000, 0.0181284, 0.0007329,     0,    74,  96882,   4082, 100964
163755,21040, 0.0000000, 0.0004235, 0.0003145,     0,     3,   2454,   7084,   9538
163758,21164, 0.0388810, 0.0026440, 0.0275071,  1993,    62,  51259,  23449,  74708
163759,21164, 0.1023820, 0.0987675, 0.1012475,  5248,  2316,  51259,  23449,  74708
163760,21164, 0.1562262, 0.0056292, 0.1089575,  8008,   132,  51259,  23449,  74708
163761,21164, 0.0005658, 0.1819694, 0.0575039,    29,  4267,  51259,  23449,  74708
163761,21118, 0.0000000, 0.0063993, 0.0005870,     0,    15,  23209,   2344,  25553
163762,21118, 0.0371839, 0.0196246, 0.0355731,   863,    46,  23209,   2344,  25553
163762,21164, 0.0000000, 0.0525396, 0.0164909,     0,  1232,  51259,  23449,  74708
163763,21118, 0.0310224, 0.0469283, 0.0324815,   720,   110,  23209,   2344,  25553
163763,21004, 0.0610369, 0.0543093, 0.0598333,  2610,   506,  42761,   9317,  52078
163764,21004, 0.5453100, 0.0155629, 0.4505357, 23318,   145,  42761,   9317,  52078
163765,21004, 0.0083253, 0.0281206, 0.0118668,   356,   262,  42761,   9317,  52078
163765,21115, 0.0000000, 0.0023485, 0.0004442,     0,    21,  38339,   8942,  47281
163766,21115, 0.1157046, 0.0030195, 0.0943931,  4436,    27,  38339,   8942,  47281
163766,21004, 0.0000000, 0.0027906, 0.0004993,     0,    26,  42761,   9317,  52078
163767,21115, 0.0408983, 0.0016775, 0.0334807,  1568,    15,  38339,   8942,  47281
163767,21065, 0.0349751, 0.0177956, 0.0334034,   605,    31,  17298,   1742,  19040
163768,21115, 0.0273351, 0.0002237, 0.0222077,  1048,     2,  38339,   8942,  47281
163769,21065, 0.0000000, 0.0654420, 0.0059874,     0,   114,  17298,   1742,  19040
164739,15086, 0.0000000, 0.0621353, 0.0573471,     0,  1885,   2533,  30337,  32870
164740,15086, 0.0000000, 0.0011207, 0.0010344,     0,    34,   2533,  30337,  32870
164741,15086, 0.0000000, 0.0175693, 0.0162154,     0,   533,   2533,  30337,  32870
164743,15086, 0.2273983, 0.0501038, 0.0637664,   576,  1520,   2533,  30337,  32870
164744,15086, 0.7726017, 0.0149982, 0.0733800,  1957,   455,   2533,  30337,  32870
164745,15086, 0.0000000, 0.0628605, 0.0580164,     0,  1907,   2533,  30337,  32870
164746,15086, 0.0000000, 0.0093945, 0.0086705,     0,   285,   2533,  30337,  32870
164747,15086, 0.0000000, 0.0342486, 0.0316094,     0,  1039,   2533,  30337,  32870
164748,15086, 0.0000000, 0.0177341, 0.0163675,     0,   538,   2533,  30337,  32870
164749,15086, 0.0000000, 0.0262715, 0.0242470,     0,   797,   2533,  30337,  32870
164750,15097, 0.0000000, 0.0212319, 0.0179988,     0,   313,   2648,  14742,  17390
164752,15021, 0.0000000, 0.0029086, 0.0023498,     0,    85,   6950,  29224,  36174
164757,15113, 0.0000000, 0.0159840, 0.0114684,     0,   688,  16948,  43043,  59991
164757,15090, 0.0330651, 0.0207101, 0.0306548,  2075,   315,  62755,  15210,  77965
164758,15090, 0.0007171, 0.0128205, 0.0030783,    45,   195,  62755,  15210,  77965
164759,15090, 0.0000637, 0.0216963, 0.0042840,     4,   330,  62755,  15210,  77965
164760,15090, 0.0701139, 0.0778435, 0.0716219,  4400,  1184,  62755,  15210,  77965
164761,15090, 0.0312963, 0.0468771, 0.0343359,  1964,   713,  62755,  15210,  77965
164761,15049, 0.1585868, 0.0503175, 0.1240654,  1387,   206,   8746,   4094,  12840
164763,15049, 0.0000000, 0.0148999, 0.0047508,     0,    61,   8746,   4094,  12840
164771,17009, 0.2863535, 0.0837871, 0.2091119,  3072,   554,  10728,   6612,  17340
164772,17009, 0.2619314, 0.0671506, 0.1876586,  2810,   444,  10728,   6612,  17340
164773,17009, 0.0000000, 0.3179068, 0.1212226,     0,  2102,  10728,   6612,  17340
164781,17023, 0.0000000, 0.0126628, 0.0052743,     0,    35,   3872,   2764,   6636
164782,17023, 0.0000000, 0.4920405, 0.2049427,     0,  1360,   3872,   2764,   6636
164783,17027, 0.0000000, 0.0777608, 0.0330893,     0,   357,   6198,   4591,  10789
164783,17023, 0.0000000, 0.0028944, 0.0012055,     0,     8,   3872,   2764,   6636
164786,15094, 0.3188974, 0.1450796, 0.2926829,  4963,   401,  15563,   2764,  18327
164787,15068, 0.5102311, 0.3488831, 0.4651009,  9999,  2655,  19597,   7610,  27207
164787,15094, 0.5139754, 0.0354559, 0.4418072,  7999,    98,  15563,   2764,  18327
164788,15015, 0.4385326, 0.0007502, 0.3963417, 10962,     2,  24997,   2666,  27663
164801,21126, 0.8572740, 0.0523718, 0.3534157,  1868,   191,   2179,   3647,   5826
164802,21140, 0.0113679, 0.0997807, 0.0120373,  1359,    91, 119547,    912, 120459
164802,21126, 0.0041303, 0.0134357, 0.0099554,     9,    49,   2179,   3647,   5826
164803,21125, 0.5945877, 0.7290970, 0.5995104,  4680,   218,   7871,    299,   8170
164803,21126, 0.0000000, 0.4677818, 0.2928253,     0,  1706,   2179,   3647,   5826
164804,21119, 0.0982095, 0.3074074, 0.1004590,  9758,   332,  99359,   1080, 100439
164805,21119, 0.1425638, 0.2435185, 0.1436494, 14165,   263,  99359,   1080, 100439
164810,21114, 0.0092652, 0.0027257, 0.0091296, 13971,    87,1507901,  31918,1539819
164811,21114, 0.0014199, 0.0010026, 0.0014112,  2141,    32,1507901,  31918,1539819
164814,21015, 0.0033959, 0.0377266, 0.0047839,   329,   154,  96882,   4082, 100964
164816,21040, 0.0000000, 0.0019763, 0.0014678,     0,    14,   2454,   7084,   9538
164817,21164, 0.0036676, 0.0017058, 0.0030519,   188,    40,  51259,  23449,  74708
164818,21164, 0.0106323, 0.0223464, 0.0143090,   545,   524,  51259,  23449,  74708
164819,21164, 0.0002536, 0.0008103, 0.0004283,    13,    19,  51259,  23449,  74708
164820,21118, 0.1614029, 0.0042662, 0.1469886,  3746,    10,  23209,   2344,  25553
164821,21164, 0.0000000, 0.0054160, 0.0017000,     0,   127,  51259,  23449,  74708
164822,21004, 0.0156451, 0.0020393, 0.0132110,   669,    19,  42761,   9317,  52078
164822,21164, 0.0000000, 0.0546292, 0.0171468,     0,  1281,  51259,  23449,  74708
164823,21004, 0.0215149, 0.0301599, 0.0230616,   920,   281,  42761,   9317,  52078
164824,21004, 0.0000000, 0.0066545, 0.0011905,     0,    62,  42761,   9317,  52078
164825,21004, 0.0000000, 0.0023613, 0.0004224,     0,    22,  42761,   9317,  52078
164826,21065, 0.1963811, 0.0665901, 0.1845063,  3397,   116,  17298,   1742,  19040
164827,21065, 0.1721008, 0.0269805, 0.1588235,  2977,    47,  17298,   1742,  19040
164828,21065, 0.2713608, 0.0045924, 0.2469538,  4694,     8,  17298,   1742,  19040
165800,15110, 0.0000000, 0.0092125, 0.0045618,     0,   281,  31097,  30502,  61599
165802,15110, 0.0000000, 0.0234739, 0.0116236,     0,   716,  31097,  30502,  61599
165805,15086, 0.0000000, 0.0064608, 0.0059629,     0,   196,   2533,  30337,  32870
165806,15086, 0.0000000, 0.0213930, 0.0197444,     0,   649,   2533,  30337,  32870
165807,15086, 0.0000000, 0.0464120, 0.0428354,     0,  1408,   2533,  30337,  32870
165808,15086, 0.0000000, 0.0049445, 0.0045634,     0,   150,   2533,  30337,  32870
165809,15086, 0.0000000, 0.0018789, 0.0017341,     0,    57,   2533,  30337,  32870
165810,15118, 0.0000000, 0.0026258, 0.0006736,     0,   113, 124724,  43035, 167759
165816,15090, 0.0440762, 0.1155161, 0.0580132,  2766,  1757,  62755,  15210,  77965
165817,15090, 0.0067246, 0.0197896, 0.0092734,   422,   301,  62755,  15210,  77965
165818,15090, 0.1002151, 0.0376068, 0.0880010,  6289,   572,  62755,  15210,  77965
165824,15063, 0.0000000, 0.0111206, 0.0094331,     0,   300,   4826,  26977,  31803
165825,15063, 0.0000000, 0.0137525, 0.0116656,     0,   371,   4826,  26977,  31803
165826,15063, 0.0000000, 0.0604218, 0.0512530,     0,  1630,   4826,  26977,  31803
165830,17009, 0.0008389, 0.0074108, 0.0033449,     9,    49,  10728,   6612,  17340
165831,17009, 0.3071402, 0.0187538, 0.1971742,  3295,   124,  10728,   6612,  17340
165842,17023, 0.0000000, 0.0007236, 0.0003014,     0,     2,   3872,   2764,   6636
165847,15015, 0.2301876, 0.7471868, 0.2800130,  5754,  1992,  24997,   2666,  27663
165847,15009, 0.0000000, 0.0017460, 0.0003717,     0,    18,  38112,  10309,  48421
165858,21102, 0.0000000, 0.0121457, 0.0004995,     0,     6,  11517,    494,  12011
165859,21126, 0.0000000, 0.0104195, 0.0065225,     0,    38,   2179,   3647,   5826
165859,21102, 0.9354867, 0.7004049, 0.9258180, 10774,   346,  11517,    494,  12011
165860,21140, 0.0011293, 0.0043860, 0.0011539,   135,     4, 119547,    912, 120459
165860,21126, 0.0000000, 0.0032904, 0.0020597,     0,    12,   2179,   3647,   5826
165861,21140, 0.0253791, 0.0712719, 0.0257266,  3034,    65, 119547,    912, 120459
165861,21126, 0.0000000, 0.4200713, 0.2629592,     0,  1532,   2179,   3647,   5826
165862,21140, 0.0562540, 0.0131579, 0.0559277,  6725,    12, 119547,    912, 120459
165863,21119, 0.0498797, 0.0666667, 0.0500602,  4956,    72,  99359,   1080, 100439
165864,21119, 0.1709357, 0.1611111, 0.1708301, 16984,   174,  99359,   1080, 100439
165870,21015, 0.2735699, 0.1016658, 0.2666198, 26504,   415,  96882,   4082, 100964
165871,21015, 0.2138168, 0.2920137, 0.2169783, 20715,  1192,  96882,   4082, 100964
165872,21015, 0.1348135, 0.3512984, 0.1435660, 13061,  1434,  96882,   4082, 100964
165873,21015, 0.2618030, 0.0195982, 0.2520106, 25364,    80,  96882,   4082, 100964
165874,21015, 0.0016308, 0.0629593, 0.0041104,   158,   257,  96882,   4082, 100964
165874,21001, 0.0176773, 0.0047064, 0.0167183,   988,    21,  55891,   4462,  60353
165875,21015, 0.0000000, 0.0181284, 0.0007329,     0,    74,  96882,   4082, 100964
165875,21001, 0.0699576, 0.0096369, 0.0654980,  3910,    43,  55891,   4462,  60353
165876,21001, 0.1015727, 0.0033617, 0.0943118,  5677,    15,  55891,   4462,  60353
165877,21164, 0.0000000, 0.0797049, 0.0250174,     0,  1869,  51259,  23449,  74708
165877,21001, 0.0000000, 0.0087405, 0.0006462,     0,    39,  55891,   4462,  60353
165878,21164, 0.0000000, 0.0933515, 0.0293007,     0,  2189,  51259,  23449,  74708
165879,21164, 0.0000000, 0.0342872, 0.0107619,     0,   804,  51259,  23449,  74708
165880,21164, 0.0000000, 0.0287432, 0.0090218,     0,   674,  51259,  23449,  74708
165881,21004, 0.0000000, 0.2463239, 0.0440685,     0,  2295,  42761,   9317,  52078
165882,21004, 0.0000000, 0.2539444, 0.0454319,     0,  2366,  42761,   9317,  52078
165884,21004, 0.0000000, 0.0046152, 0.0008257,     0,    43,  42761,   9317,  52078
165885,21065, 0.0132385, 0.6016073, 0.0670693,   229,  1048,  17298,   1742,  19040
166857,15110, 0.0000000, 0.0026556, 0.0013150,     0,    81,  31097,  30502,  61599
166860,15110, 0.0000000, 0.0112124, 0.0055520,     0,   342,  31097,  30502,  61599
166862,15086, 0.0000000, 0.0505983, 0.0466991,     0,  1535,   2533,  30337,  32870
166863,15110, 0.0000000, 0.0072782, 0.0036040,     0,   222,  31097,  30502,  61599
166864,15086, 0.0000000, 0.0064937, 0.0059933,     0,   197,   2533,  30337,  32870
166865,15086, 0.0000000, 0.0447309, 0.0412838,     0,  1357,   2533,  30337,  32870
166866,15086, 0.0000000, 0.0013185, 0.0012169,     0,    40,   2533,  30337,  32870
166867,15086, 0.0000000, 0.0028678, 0.0026468,     0,    87,   2533,  30337,  32870
166874,15090, 0.0000000, 0.0028271, 0.0005515,     0,    43,  62755,  15210,  77965
166875,15090, 0.0682655, 0.1270874, 0.0797409,  4284,  1933,  62755,  15210,  77965
166877,15090, 0.0951159, 0.2581197, 0.1269159,  5969,  3926,  62755,  15210,  77965
166878,15090, 0.2180543, 0.0533859, 0.1859296, 13684,   812,  62755,  15210,  77965
166880,15049, 0.3973245, 0.2327797, 0.3448598,  3475,   953,   8746,   4094,  12840
166883,15063, 0.0000000, 0.0038181, 0.0032387,     0,   103,   4826,  26977,  31803
166883,15101, 0.0000000, 0.0234856, 0.0082058,     0,   580,  45986,  24696,  70682
166884,15063, 0.0000000, 0.0719502, 0.0610320,     0,  1941,   4826,  26977,  31803
166884,15101, 0.0000000, 0.0142938, 0.0049942,     0,   353,  45986,  24696,  70682
166890,17009, 0.0000000, 0.0311555, 0.0118800,     0,   206,  10728,   6612,  17340
166891,9012 , 0.0000000, 0.0001109, 0.0000015,     0,     1, 641550,   9017, 650567
166902,15050, 0.3276790, 0.1236603, 0.3171469,  7302,   150,  22284,   1213,  23497
166903,15050, 0.4426943, 0.3990107, 0.4404392,  9865,   484,  22284,   1213,  23497
166904,15050, 0.0004039, 0.1714757, 0.0092352,     9,   208,  22284,   1213,  23497
166905,15009, 0.0000000, 0.0037831, 0.0008054,     0,    39,  38112,  10309,  48421
166906,15009, 0.0000000, 0.4566883, 0.0972305,     0,  4708,  38112,  10309,  48421
166907,15015, 0.0000000, 0.1609152, 0.0155081,     0,   429,  24997,   2666,  27663
166907,15009, 0.0719458, 0.0091182, 0.0585696,  2742,    94,  38112,  10309,  48421
166908,15015, 0.0000000, 0.0498875, 0.0048079,     0,   133,  24997,   2666,  27663
166915,21138, 0.2076596, 0.0990099, 0.2056231,  2196,    20,  10575,    202,  10777
166916,21102, 0.0000000, 0.0708502, 0.0029140,     0,    35,  11517,    494,  12011
166916,21138, 0.7609456, 0.9009901, 0.7635706,  8047,   182,  10575,    202,  10777
166917,21102, 0.0000000, 0.2165992, 0.0089085,     0,   107,  11517,    494,  12011
166919,21026, 0.0000000, 0.0560816, 0.0056082,     0,    77,  12357,   1373,  13730
166920,21140, 0.0135595, 0.0065789, 0.0135067,  1621,     6, 119547,    912, 120459
166921,21140, 0.0198081, 0.0109649, 0.0197412,  2368,    10, 119547,    912, 120459
166922,21140, 0.2452090, 0.2664474, 0.2453698, 29314,   243, 119547,    912, 120459
166923,21041, 0.0287752, 0.6071429, 0.0733769,  2102,  3706,  73049,   6104,  79153
166929,21114, 0.0408667, 0.0025378, 0.0400722, 61623,    81,1507901,  31918,1539819
166930,21114, 0.0005186, 0.0707438, 0.0019743,   782,  2258,1507901,  31918,1539819
166931,21015, 0.0135010, 0.0749633, 0.0159859,  1308,   306,  96882,   4082, 100964
166933,21001, 0.0499902, 0.0044823, 0.0466257,  2794,    20,  55891,   4462,  60353
166934,21001, 0.0731066, 0.0295831, 0.0698888,  4086,   132,  55891,   4462,  60353
166934,21163, 0.5350326, 0.0368421, 0.5292166,  8606,     7,  16085,    190,  16275
166935,21001, 0.0769712, 0.0033617, 0.0715292,  4302,    15,  55891,   4462,  60353
166935,21163, 0.0513522, 0.3210526, 0.0545008,   826,    61,  16085,    190,  16275
166936,21164, 0.0000000, 0.0004265, 0.0001339,     0,    10,  51259,  23449,  74708
166936,21001, 0.0431196, 0.4078888, 0.0700876,  2410,  1820,  55891,   4462,  60353
166937,21001, 0.0003399, 0.0143433, 0.0013752,    19,    64,  55891,   4462,  60353
166938,21164, 0.0000000, 0.1380016, 0.0433153,     0,  3236,  51259,  23449,  74708
166939,21164, 0.0000000, 0.0975308, 0.0306125,     0,  2287,  51259,  23449,  74708
166940,21004, 0.0000000, 0.0012880, 0.0002304,     0,    12,  42761,   9317,  52078
166940,21164, 0.0000000, 0.0393620, 0.0123548,     0,   923,  51259,  23449,  74708
166942,21004, 0.0008419, 0.0010733, 0.0008833,    36,    10,  42761,   9317,  52078
166943,21004, 0.1580412, 0.0128797, 0.1320711,  6758,   120,  42761,   9317,  52078
166944,21065, 0.0000000, 0.0040184, 0.0003676,     0,     7,  17298,   1742,  19040
166944,21004, 0.0000000, 0.0023613, 0.0004224,     0,    22,  42761,   9317,  52078
167916,15110, 0.0000000, 0.0001311, 0.0000649,     0,     4,  31097,  30502,  61599
167917,15110, 0.0000000, 0.0185562, 0.0091885,     0,   566,  31097,  30502,  61599
167918,15110, 0.0000000, 0.0177365, 0.0087826,     0,   541,  31097,  30502,  61599
167919,15110, 0.0000000, 0.0049177, 0.0024351,     0,   150,  31097,  30502,  61599
167920,15110, 0.0000000, 0.0476690, 0.0236043,     0,  1454,  31097,  30502,  61599
167921,15110, 0.0000000, 0.0105895, 0.0052436,     0,   323,  31097,  30502,  61599
167922,15110, 0.0000000, 0.0131795, 0.0065261,     0,   402,  31097,  30502,  61599
167923,15110, 0.0000000, 0.0075077, 0.0037176,     0,   229,  31097,  30502,  61599
167924,15086, 0.0000000, 0.0703102, 0.0648920,     0,  2133,   2533,  30337,  32870
167925,15086, 0.0000000, 0.0261397, 0.0241253,     0,   793,   2533,  30337,  32870
167934,15018, 0.0011456, 0.0973157, 0.0330619,    36,  1519,  31424,  15609,  47033
167936,15090, 0.0431519, 0.1761999, 0.0691079,  2708,  2680,  62755,  15210,  77965
167936,15018, 0.0000000, 0.0007047, 0.0002339,     0,    11,  31424,  15609,  47033
167936,15072, 0.0000000, 0.0004810, 0.0001569,     0,     2,   8590,   4158,  12748
167937,15072, 0.0739232, 0.9867725, 0.3716661,   635,  4103,   8590,   4158,  12748
167938,15090, 0.0424827, 0.0055227, 0.0352722,  2666,    84,  62755,  15210,  77965
167939,15049, 0.1415504, 0.0639961, 0.1168224,  1238,   262,   8746,   4094,  12840
167939,15098, 0.1488211, 0.6803279, 0.1995696,   688,   332,   4623,    488,   5111
167940,15098, 0.8511789, 0.2028688, 0.7892780,  3935,    99,   4623,    488,   5111
167940,15101, 0.0000000, 0.0850340, 0.0297105,     0,  2100,  45986,  24696,  70682
167941,15101, 0.0000000, 0.0301668, 0.0105402,     0,   745,  45986,  24696,  70682
167942,15101, 0.0704997, 0.1855361, 0.1106930,  3242,  4582,  45986,  24696,  70682
167943,15101, 0.0000000, 0.1335844, 0.0466738,     0,  3299,  45986,  24696,  70682
167947,15043, 0.0000000, 0.0170868, 0.0075191,     0,   202,  15043,  11822,  26865
167950,9012 , 0.0000000, 0.0006654, 0.0000092,     0,     6, 641550,   9017, 650567
167961,15050, 0.1639742, 0.2728772, 0.1695961,  3654,   331,  22284,   1213,  23497
167962,15050, 0.0652486, 0.0329761, 0.0635826,  1454,    40,  22284,   1213,  23497
167963,15017, 0.0000000, 0.0007726, 0.0004513,     0,     4,   3687,   5177,   8864
167964,15017, 0.5104421, 0.3391926, 0.4104242,  1882,  1756,   3687,   5177,   8864
167965,15009, 0.3972502, 0.0269667, 0.3184156, 15140,   278,  38112,  10309,  48421
167965,15017, 0.0000000, 0.1085571, 0.0634025,     0,   562,   3687,   5177,   8864
167966,15009, 0.0647565, 0.0198855, 0.0552033,  2468,   205,  38112,  10309,  48421
167967,15009, 0.0000000, 0.0042681, 0.0009087,     0,    44,  38112,  10309,  48421
167976,21026, 0.5337865, 0.2549163, 0.5058995,  6596,   350,  12357,   1373,  13730
167977,21026, 0.0411912, 0.6875455, 0.1058267,   509,   944,  12357,   1373,  13730
167978,21026, 0.0000000, 0.0014567, 0.0001457,     0,     2,  12357,   1373,  13730
167979,21140, 0.0000000, 0.0032895, 0.0000249,     0,     3, 119547,    912, 120459
167980,21140, 0.0266422, 0.5241228, 0.0304087,  3185,   478, 119547,    912, 120459
167981,21090, 0.2089150, 0.1184971, 0.2072276,  3801,    41,  18194,    346,  18540
167982,21034, 0.0674650, 0.3576471, 0.0781593,  2248,   456,  33321,   1275,  34596
167984,21041, 0.2103656, 0.0170380, 0.1954569, 15367,   104,  73049,   6104,  79153
167987,21114, 0.0080887, 0.0582117, 0.0091277, 12197,  1858,1507901,  31918,1539819
167988,21114, 0.0106698, 0.0076759, 0.0106077, 16089,   245,1507901,  31918,1539819
167989,21114, 0.0029571, 0.0063287, 0.0030270,  4459,   202,1507901,  31918,1539819
167990,21015, 0.0259491, 0.0002450, 0.0249099,  2514,     1,  96882,   4082, 100964
167990,21114, 0.0000000, 0.0710258, 0.0014723,     0,  2267,1507901,  31918,1539819
167991,21015, 0.0000000, 0.0002450, 0.0000099,     0,     1,  96882,   4082, 100964
167993,21163, 0.4112527, 0.5000000, 0.4122888,  6615,    95,  16085,    190,  16275
167993,21001, 0.0003578, 0.0127745, 0.0012758,    20,    57,  55891,   4462,  60353
167995,21001, 0.0193054, 0.0244285, 0.0196842,  1079,   109,  55891,   4462,  60353
167996,21001, 0.0001968, 0.0208427, 0.0017232,    11,    93,  55891,   4462,  60353
167999,21004, 0.0000000, 0.1148438, 0.0205461,     0,  1070,  42761,   9317,  52078
168000,21152, 0.0000000, 0.0011630, 0.0005126,     0,     6,   6547,   5159,  11706
168001,21152, 0.0000000, 0.2950184, 0.1300188,     0,  1522,   6547,   5159,  11706
168003,21004, 0.0000000, 0.0036492, 0.0006529,     0,    34,  42761,   9317,  52078
168004,21096, 0.0000000, 0.0248344, 0.0113938,     0,    30,   1425,   1208,   2633
168005,21142, 0.0000000, 0.0417787, 0.0073130,     0,   202,  22787,   4835,  27622
168975,15110, 0.0000000, 0.0511770, 0.0253413,     0,  1561,  31097,  30502,  61599
168977,15110, 0.0969225, 0.0588158, 0.0780532,  3014,  1794,  31097,  30502,  61599
168978,15110, 0.0000000, 0.0564225, 0.0279388,     0,  1721,  31097,  30502,  61599
168979,15110, 0.0000000, 0.0357354, 0.0176951,     0,  1090,  31097,  30502,  61599
168980,15110, 0.0000000, 0.0038030, 0.0018831,     0,   116,  31097,  30502,  61599
168981,15110, 0.0000000, 0.0478001, 0.0236692,     0,  1458,  31097,  30502,  61599
168982,15110, 0.0000000, 0.0016392, 0.0008117,     0,    50,  31097,  30502,  61599
168984,15086, 0.0000000, 0.0569931, 0.0526012,     0,  1729,   2533,  30337,  32870
168985,15086, 0.0000000, 0.1028447, 0.0949194,     0,  3120,   2533,  30337,  32870
168986,15118, 0.0000000, 0.0152202, 0.0039044,     0,   655, 124724,  43035, 167759
168988,15118, 0.0000000, 0.0277449, 0.0071174,     0,  1194, 124724,  43035, 167759
168993,15018, 0.0633274, 0.0011532, 0.0426934,  1990,    18,  31424,  15609,  47033
168994,15018, 0.2590377, 0.2554296, 0.2578402,  8140,  3987,  31424,  15609,  47033
168995,15072, 0.0000000, 0.0007215, 0.0002353,     0,     3,   8590,   4158,  12748
168995,15018, 0.2034114, 0.0130694, 0.1402420,  6392,   204,  31424,  15609,  47033
168996,15072, 0.9260768, 0.0108225, 0.6275494,  7955,    45,   8590,   4158,  12748
168997,15072, 0.0000000, 0.0012025, 0.0003922,     0,     5,   8590,   4158,  12748
168997,15073, 0.0836045, 0.6265923, 0.1143915,  1747,   787,  20896,   1256,  22152
168999,15098, 0.0000000, 0.1168033, 0.0111524,     0,    57,   4623,    488,   5111
168999,15006, 0.8819817, 0.9209572, 0.8869190,  8385,  1270,   9507,   1379,  10886
169000,15006, 0.0000000, 0.0790428, 0.0100129,     0,   109,   9507,   1379,  10886
169000,15043, 0.0000000, 0.0658941, 0.0289968,     0,   779,  15043,  11822,  26865
169000,15101, 0.0171356, 0.0643019, 0.0336153,   788,  1588,  45986,  24696,  70682
169001,15101, 0.0087635, 0.0749919, 0.0319035,   403,  1852,  45986,  24696,  70682
169002,15101, 0.0000000, 0.0055475, 0.0019383,     0,   137,  45986,  24696,  70682
169002,15043, 0.0000000, 0.0828963, 0.0364787,     0,   980,  15043,  11822,  26865
169003,15043, 0.0000000, 0.0053290, 0.0023451,     0,    63,  15043,  11822,  26865
169006,15043, 0.0000000, 0.0013534, 0.0005956,     0,    16,  15043,  11822,  26865
169010,9012 , 0.0016133, 0.0087612, 0.0017124,  1035,    79, 641550,   9017, 650567
169011,9012 , 0.0000000, 0.0063214, 0.0000876,     0,    57, 641550,   9017, 650567
169017,9009 , 0.0000000, 0.0050269, 0.0006433,     0,    84, 113872,  16710, 130582
169021,15089, 0.5078614, 0.9558224, 0.7053318,  3004,  4457,   5915,   4663,  10578
169022,15017, 0.0000000, 0.0988990, 0.0577617,     0,   512,   3687,   5177,   8864
169023,15017, 0.4895579, 0.2101603, 0.3263763,  1805,  1088,   3687,   5177,   8864
169024,15017, 0.0000000, 0.2424184, 0.1415839,     0,  1255,   3687,   5177,   8864
169024,15009, 0.2657956, 0.0022311, 0.2096817, 10130,    23,  38112,  10309,  48421
169025,15009, 0.1433407, 0.2132118, 0.1582165,  5463,  2198,  38112,  10309,  48421
169026,15009, 0.0000000, 0.0006790, 0.0001446,     0,     7,  38112,  10309,  48421
169033,21074, 0.0010006, 0.0013560, 0.0010874,    48,    21,  47970,  15487,  63457
169034,21074, 0.0610798, 0.0591464, 0.0606080,  2930,   916,  47970,  15487,  63457
169035,21060, 0.8047408, 0.0619224, 0.6890296,  4719,    67,   5864,   1082,   6946
169036,21060, 0.1899727, 0.9380776, 0.3065073,  1114,  1015,   5864,   1082,   6946
169036,21074, 0.0000000, 0.0014851, 0.0003625,     0,    23,  47970,  15487,  63457
169037,21074, 0.0090890, 0.0405501, 0.0167673,   436,   628,  47970,  15487,  63457
169038,21074, 0.0000000, 0.0428101, 0.0104480,     0,   663,  47970,  15487,  63457
169038,21090, 0.2271078, 0.1271676, 0.2252427,  4132,    44,  18194,    346,  18540
169039,21090, 0.1717050, 0.5375723, 0.1785329,  3124,   186,  18194,    346,  18540
169040,21090, 0.0021436, 0.2167630, 0.0061489,    39,    75,  18194,    346,  18540
169040,21034, 0.2423097, 0.1741176, 0.2397965,  8074,   222,  33321,   1275,  34596
169041,21034, 0.3084541, 0.1615686, 0.3030408, 10278,   206,  33321,   1275,  34596
169042,21041, 0.0077208, 0.0011468, 0.0072139,   564,     7,  73049,   6104,  79153
169043,21041, 0.0512670, 0.1890564, 0.0618928,  3745,  1154,  73049,   6104,  79153
169044,29025, 0.0058892, 0.1112426, 0.0071680,   405,    94,  68770,    845,  69615
169044,21114, 0.0044890, 0.0030077, 0.0044583,  6769,    96,1507901,  31918,1539819
169044,29027, 0.1555517, 0.5511811, 0.1598232,  1810,    70,  11636,    127,  11763
169045,29025, 0.4580631, 0.0307692, 0.4528765, 31501,    26,  68770,    845,  69615
169045,29027, 0.0000000, 0.1181102, 0.0012752,     0,    15,  11636,    127,  11763
169046,21114, 0.0000000, 0.0153832, 0.0003189,     0,   491,1507901,  31918,1539819
169046,29025, 0.2925985, 0.2946745, 0.2926237, 20122,   249,  68770,    845,  69615
169047,21114, 0.0001001, 0.0206467, 0.0005260,   151,   659,1507901,  31918,1539819
169047,29025, 0.0000000, 0.1431953, 0.0017381,     0,   121,  68770,    845,  69615
169048,21114, 0.0000000, 0.0001880, 0.0000039,     0,     6,1507901,  31918,1539819
169049,21114, 0.0000000, 0.0020051, 0.0000416,     0,    64,1507901,  31918,1539819
169050,21015, 0.0000000, 0.0009799, 0.0000396,     0,     4,  96882,   4082, 100964
169051,21001, 0.0778837, 0.0300314, 0.0743459,  4353,   134,  55891,   4462,  60353
169052,21001, 0.0771323, 0.0100852, 0.0721754,  4311,    45,  55891,   4462,  60353
169053,21001, 0.2500939, 0.1107127, 0.2397892, 13978,   494,  55891,   4462,  60353
169054,21001, 0.0347462, 0.0425818, 0.0353255,  1942,   190,  55891,   4462,  60353
169055,21001, 0.0000000, 0.0096369, 0.0007125,     0,    43,  55891,   4462,  60353
169058,21104, 0.0000000, 0.0883361, 0.0255020,     0,   696,  19413,   7879,  27292
169059,21152, 0.0000000, 0.1133941, 0.0499744,     0,   585,   6547,   5159,  11706
169061,21152, 0.5316939, 0.1808490, 0.3770716,  3481,   933,   6547,   5159,  11706
169062,21096, 0.9228070, 0.1266556, 0.5575389,  1315,   153,   1425,   1208,   2633
169063,21142, 0.0195726, 0.0010341, 0.0163276,   446,     5,  22787,   4835,  27622
169063,21096, 0.0000000, 0.7061259, 0.3239651,     0,   853,   1425,   1208,   2633
169064,21142, 0.0735946, 0.0122027, 0.0628485,  1677,    59,  22787,   4835,  27622
170034,15110, 0.0000000, 0.0142614, 0.0070618,     0,   435,  31097,  30502,  61599
170037,15110, 0.0000000, 0.0449479, 0.0222569,     0,  1371,  31097,  30502,  61599
170038,15110, 0.0000000, 0.0058357, 0.0028897,     0,   178,  31097,  30502,  61599
170039,15110, 0.0000000, 0.0125893, 0.0062339,     0,   384,  31097,  30502,  61599
170039,15007, 0.0000000, 0.0070171, 0.0066031,     0,   151,   1349,  21519,  22868
170047,15118, 0.0000000, 0.0066922, 0.0017167,     0,   288, 124724,  43035, 167759
170052,15018, 0.0000000, 0.0718175, 0.0238343,     0,  1121,  31424,  15609,  47033
170053,15018, 0.0619908, 0.0025626, 0.0422682,  1948,    40,  31424,  15609,  47033
170054,15018, 0.0050916, 0.1194824, 0.0430549,   160,  1865,  31424,  15609,  47033
170055,15073, 0.2226742, 0.1751592, 0.2199801,  4653,   220,  20896,   1256,  22152
170055,15018, 0.1629328, 0.2468448, 0.1907809,  5120,  3853,  31424,  15609,  47033
170055,15027, 0.0133628, 0.1785047, 0.0316246,   115,   191,   8606,   1070,   9676
170056,15018, 0.0000000, 0.0568903, 0.0188804,     0,   888,  31424,  15609,  47033
170056,15073, 0.1778809, 0.0222930, 0.1690592,  3717,    28,  20896,   1256,  22152
170056,15027, 0.0000000, 0.0588785, 0.0065110,     0,    63,   8606,   1070,   9676
170057,15101, 0.0091767, 0.0277373, 0.0156617,   422,   685,  45986,  24696,  70682
170057,15073, 0.0000000, 0.1759554, 0.0099765,     0,   221,  20896,   1256,  22152
170058,15012, 1.0000000, 1.0000000, 1.0000000,  8062,  2237,   8062,   2237,  10299
170058,15101, 0.0593441, 0.0197198, 0.0454996,  2729,   487,  45986,  24696,  70682
170059,15101, 0.4070369, 0.0378199, 0.2780340, 18718,   934,  45986,  24696,  70682
170060,15043, 0.3552483, 0.3117916, 0.3361251,  5344,  3686,  15043,  11822,  26865
170061,15043, 0.6447517, 0.5156488, 0.5879397,  9699,  6096,  15043,  11822,  26865
170061,15101, 0.0371200, 0.0576207, 0.0442828,  1707,  1423,  45986,  24696,  70682
170067,9012 , 0.0000000, 0.0002218, 0.0000031,     0,     2, 641550,   9017, 650567
170068,9012 , 0.0000000, 0.0009981, 0.0000138,     0,     9, 641550,   9017, 650567
170069,9012 , 0.0000421, 0.0608850, 0.0008854,    27,   549, 641550,   9017, 650567
170070,9012 , 0.0019749, 0.0700898, 0.0029190,  1267,   632, 641550,   9017, 650567
170072,9009 , 0.0405543, 0.0759425, 0.0450828,  4618,  1269, 113872,  16710, 130582
170073,9009 , 0.0653541, 0.0779174, 0.0669618,  7442,  1302, 113872,  16710, 130582
170074,9009 , 0.0618765, 0.0783363, 0.0639828,  7046,  1309, 113872,  16710, 130582
170075,9009 , 0.0997260, 0.0467983, 0.0929531, 11356,   782, 113872,  16710, 130582
170076,9009 , 0.0018266, 0.0155595, 0.0035840,   208,   260, 113872,  16710, 130582
170079,15083, 0.0000000, 0.0012561, 0.0006247,     0,     7,   5633,   5573,  11206
170080,15089, 0.4921386, 0.0441776, 0.2946682,  2911,   206,   5915,   4663,  10578
170082,15009, 0.0000000, 0.0033951, 0.0007228,     0,    35,  38112,  10309,  48421
170082,15103, 0.0000000, 0.0119377, 0.0027097,     0,   125,  35659,  10471,  46130
170083,15009, 0.0019679, 0.2580270, 0.0564838,    75,  2660,  38112,  10309,  48421
170083,15103, 0.0000000, 0.3779009, 0.0857793,     0,  3957,  35659,  10471,  46130
170092,21048, 0.0460514, 0.0272687, 0.0438120,   761,    61,  16525,   2237,  18762
170093,21048, 0.0910741, 0.0040232, 0.0806950,  1505,     9,  16525,   2237,  18762
170094,21074, 0.0000000, 0.0229225, 0.0055943,     0,   355,  47970,  15487,  63457
170095,21074, 0.0330415, 0.3143281, 0.1016909,  1585,  4868,  47970,  15487,  63457
170096,21074, 0.4884511, 0.0038096, 0.3701719, 23431,    59,  47970,  15487,  63457
170097,21074, 0.0000000, 0.0056176, 0.0013710,     0,    87,  47970,  15487,  63457
170098,21181, 0.5457882, 0.5620438, 0.5464987,  3272,   154,   5995,    274,   6269
170099,21181, 0.0000000, 0.4379562, 0.0191418,     0,   120,   5995,    274,   6269
170100,21034, 0.1343897, 0.2219608, 0.1376171,  4478,   283,  33321,   1275,  34596
170100,21136, 0.1999290, 0.0395137, 0.1953785,  2253,    13,  11269,    329,  11598
170101,21034, 0.0000000, 0.0847059, 0.0031217,     0,   108,  33321,   1275,  34596
170101,21041, 0.0396309, 0.1856160, 0.0508888,  2895,  1133,  73049,   6104,  79153
170103,29027, 0.8154005, 0.0551181, 0.8071920,  9488,     7,  11636,    127,  11763
170104,29027, 0.0169302, 0.2755905, 0.0197229,   197,    35,  11636,    127,  11763
170105,29025, 0.0079250, 0.0437870, 0.0083603,   545,    37,  68770,    845,  69615
170106,21114, 0.0041846, 0.0048875, 0.0041992,  6310,   156,1507901,  31918,1539819
170106,29025, 0.1076778, 0.1455621, 0.1081376,  7405,   123,  68770,    845,  69615
170107,21114, 0.0056721, 0.0507237, 0.0066060,  8553,  1619,1507901,  31918,1539819
170107,29028, 0.0000000, 0.0294431, 0.0038300,     0,    83,  18852,   2819,  21671
170108,21114, 0.0000000, 0.0003446, 0.0000071,     0,    11,1507901,  31918,1539819
170109,21114, 0.0000000, 0.0001253, 0.0000026,     0,     4,1507901,  31918,1539819
170109,21163, 0.0000000, 0.0421053, 0.0004916,     0,     8,  16085,    190,  16275
170110,21163, 0.0000000, 0.0842105, 0.0009831,     0,    16,  16085,    190,  16275
170111,21001, 0.0000000, 0.0100852, 0.0007456,     0,    45,  55891,   4462,  60353
170112,21001, 0.0000000, 0.1515016, 0.0112008,     0,   676,  55891,   4462,  60353
170113,21001, 0.0000537, 0.0015688, 0.0001657,     3,     7,  55891,   4462,  60353
170114,21104, 0.1728223, 0.0116766, 0.1263008,  3355,    92,  19413,   7879,  27292
170115,21104, 0.0000000, 0.0003808, 0.0001099,     0,     3,  19413,   7879,  27292
170116,21104, 0.0000000, 0.1181622, 0.0341126,     0,   931,  19413,   7879,  27292
170118,21152, 0.0000000, 0.3531692, 0.1556467,     0,  1822,   6547,   5159,  11706
170118,21104, 0.0000000, 0.0888438, 0.0256485,     0,   700,  19413,   7879,  27292
170119,21152, 0.0096227, 0.0279124, 0.0176832,    63,   144,   6547,   5159,  11706
170120,21152, 0.3427524, 0.0284939, 0.2042542,  2244,   147,   6547,   5159,  11706
170120,21096, 0.0000000, 0.0124172, 0.0056969,     0,    15,   1425,   1208,   2633
170121,21096, 0.0000000, 0.0033113, 0.0015192,     0,     4,   1425,   1208,   2633
170122,21142, 0.2152982, 0.0070321, 0.1788429,  4906,    34,  22787,   4835,  27622
170123,21142, 0.4434546, 0.0543950, 0.3753530, 10105,   263,  22787,   4835,  27622
171093,15110, 0.0000000, 0.0011475, 0.0005682,     0,    35,  31097,  30502,  61599
171094,15110, 0.0257260, 0.0343912, 0.0300167,   800,  1049,  31097,  30502,  61599
171095,15110, 0.0496189, 0.1272376, 0.0880534,  1543,  3881,  31097,  30502,  61599
171096,15110, 0.0000000, 0.0302275, 0.0149678,     0,   922,  31097,  30502,  61599
171097,15007, 0.0000000, 0.0126865, 0.0119381,     0,   273,   1349,  21519,  22868
171099,15007, 0.0000000, 0.0104559, 0.0098391,     0,   225,   1349,  21519,  22868
171100,15007, 0.0000000, 0.0129188, 0.0121567,     0,   278,   1349,  21519,  22868
171105,15118, 0.0000000, 0.0130127, 0.0033381,     0,   560, 124724,  43035, 167759
171106,15118, 0.0000000, 0.0006274, 0.0001609,     0,    27, 124724,  43035, 167759
171107,15118, 0.0000000, 0.0484025, 0.0124166,     0,  2083, 124724,  43035, 167759
171108,15118, 0.0000000, 0.0000232, 0.0000060,     0,     1, 124724,  43035, 167759
171110,15106, 0.0000672, 0.0119299, 0.0009529,    51,   730, 758370,  61191, 819561
171111,15106, 0.0208144, 0.0458074, 0.0226804, 15785,  2803, 758370,  61191, 819561
171112,15018, 0.2396258, 0.0566340, 0.1788957,  7530,   884,  31424,  15609,  47033
171112,15054, 0.0154849, 0.0217839, 0.0156564,  3226,   127, 208332,   5830, 214162
171113,15055, 0.1730115, 0.2124814, 0.1798156,  1677,   429,   9693,   2019,  11712
171114,15027, 0.2958401, 0.0757009, 0.2714965,  2546,    81,   8606,   1070,   9676
171114,15018, 0.0034687, 0.0780960, 0.0282355,   109,  1219,  31424,  15609,  47033
171114,15055, 0.8269886, 0.7875186, 0.8201845,  8016,  1590,   9693,   2019,  11712
171115,15027, 0.6906809, 0.6869159, 0.6902646,  5944,   735,   8606,   1070,   9676
171116,15101, 0.0426434, 0.0237690, 0.0360488,  1961,   587,  45986,  24696,  70682
171117,15019, 0.0002312, 0.1673203, 0.0189731,     7,   640,  30276,   3825,  34101
171118,15019, 0.3425485, 0.7406536, 0.3872027, 10371,  2833,  30276,   3825,  34101
171119,15101, 0.0300526, 0.1447198, 0.0701169,  1382,  3574,  45986,  24696,  70682
171119,15019, 0.1483023, 0.0211765, 0.1340430,  4490,    81,  30276,   3825,  34101
171120,15101, 0.0015222, 0.0364027, 0.0137093,    70,   899,  45986,  24696,  70682
171126,9012 , 0.0006968, 0.0343795, 0.0011636,   447,   310, 641550,   9017, 650567
171127,9012 , 0.0114317, 0.1313075, 0.0130932,  7334,  1184, 641550,   9017, 650567
171128,9012 , 0.0085917, 0.1324165, 0.0103079,  5512,  1194, 641550,   9017, 650567
171129,9012 , 0.0467695, 0.1582566, 0.0483148, 30005,  1427, 641550,   9017, 650567
171130,9013 , 0.0206087, 0.0563044, 0.0212213,  8406,   401, 407885,   7122, 415007
171130,9009 , 0.0008606, 0.0028725, 0.0011181,    98,    48, 113872,  16710, 130582
171130,9012 , 0.0011924, 0.0054342, 0.0012512,   765,    49, 641550,   9017, 650567
171131,9009 , 0.1322099, 0.1337522, 0.1324072, 15055,  2235, 113872,  16710, 130582
171131,9013 , 0.0073329, 0.0744173, 0.0084842,  2991,   530, 407885,   7122, 415007
171132,9009 , 0.1176057, 0.1341712, 0.1197255, 13392,  2242, 113872,  16710, 130582
171133,9009 , 0.1269144, 0.1201077, 0.1260434, 14452,  2007, 113872,  16710, 130582
171134,9009 , 0.1472179, 0.1061640, 0.1419644, 16764,  1774, 113872,  16710, 130582
171135,9009 , 0.0478344, 0.0357271, 0.0462851,  5447,   597, 113872,  16710, 130582
171135,9011 , 0.0007746, 0.0288608, 0.0010825,   276,   114, 356315,   3950, 360265
171136,15025, 0.0273752, 0.1923723, 0.0337084,  8164,  2290, 298226,  11904, 310130
171137,15025, 0.0305305, 0.2383233, 0.0385064,  9105,  2837, 298226,  11904, 310130
171138,15083, 0.0021303, 0.2714875, 0.1360878,    12,  1513,   5633,   5573,  11206
171138,15025, 0.0000000, 0.1336526, 0.0051301,     0,  1591, 298226,  11904, 310130
171139,15083, 0.9609444, 0.3143729, 0.6393896,  5413,  1752,   5633,   5573,  11206
171140,15103, 0.0000000, 0.1997899, 0.0453501,     0,  2092,  35659,  10471,  46130
171140,15025, 0.0000000, 0.0107527, 0.0004127,     0,   128, 298226,  11904, 310130
171141,15103, 0.2860989, 0.0559641, 0.2338608, 10202,   586,  35659,  10471,  46130
171142,15103, 0.2877534, 0.0375322, 0.2309560, 10261,   393,  35659,  10471,  46130
171143,15103, 0.0336240, 0.0462229, 0.0364839,  1199,   484,  35659,  10471,  46130
171151,21048, 0.0020575, 0.8877962, 0.1076644,    34,  1986,  16525,   2237,  18762
171153,21074, 0.0000000, 0.0136243, 0.0033251,     0,   211,  47970,  15487,  63457
171153,21048, 0.1380333, 0.0657130, 0.1294105,  2281,   147,  16525,   2237,  18762
171154,21074, 0.0000000, 0.1448312, 0.0353468,     0,  2243,  47970,  15487,  63457
171155,21074, 0.0080675, 0.2961193, 0.0783680,   387,  4586,  47970,  15487,  63457
171156,21074, 0.0085887, 0.0182734, 0.0109523,   412,   283,  47970,  15487,  63457
171157,29023, 0.0000000, 0.1380208, 0.0628254,     0,  1484,  12869,  10752,  23621
171157,21074, 0.0000000, 0.0148512, 0.0036245,     0,   230,  47970,  15487,  63457
171158,21136, 0.2023250, 0.3069909, 0.2052940,  2280,   101,  11269,    329,  11598
171158,29023, 0.0000000, 0.0108817, 0.0049532,     0,   117,  12869,  10752,  23621
171159,21136, 0.0003550, 0.6534954, 0.0188826,     4,   215,  11269,    329,  11598
171159,29044, 0.0000000, 0.3031915, 0.0014746,     0,    57,  38466,    188,  38654
171159,29032, 0.0000000, 0.0018622, 0.0006446,     0,     8,   8114,   4296,  12410
171160,29044, 0.1091873, 0.3670213, 0.1104414,  4200,    69,  38466,    188,  38654
171162,29041, 0.2726494, 0.5163399, 0.2740304,  7319,    79,  26844,    153,  26997
171163,29041, 0.0010058, 0.4640523, 0.0036300,    27,    71,  26844,    153,  26997
171163,29017, 0.6244442, 0.8115942, 0.6257700,  6039,    56,   9671,     69,   9740
171164,29025, 0.0000000, 0.0189349, 0.0002298,     0,    16,  68770,    845,  69615
171164,29041, 0.0000000, 0.0196078, 0.0001111,     0,     3,  26844,    153,  26997
171165,29025, 0.0065581, 0.1325444, 0.0080873,   451,   112,  68770,    845,  69615
171166,21114, 0.0000000, 0.0025378, 0.0000526,     0,    81,1507901,  31918,1539819
171166,29028, 0.0000000, 0.0117063, 0.0015228,     0,    33,  18852,   2819,  21671
171166,29025, 0.0003490, 0.0792899, 0.0013072,    24,    67,  68770,    845,  69615
171167,21114, 0.0000000, 0.0000627, 0.0000013,     0,     2,1507901,  31918,1539819
171169,21163, 0.0000000, 0.0157895, 0.0001843,     0,     3,  16085,    190,  16275
171170,21001, 0.0000000, 0.0141192, 0.0010439,     0,    63,  55891,   4462,  60353
171171,21001, 0.0000000, 0.0484088, 0.0035789,     0,   216,  55891,   4462,  60353
171172,21001, 0.0000000, 0.0271179, 0.0020049,     0,   121,  55891,   4462,  60353
171172,21104, 0.0517179, 0.0101536, 0.0397186,  1004,    80,  19413,   7879,  27292
171172,29037, 0.0000000, 0.0617284, 0.0145914,     0,   120,   6280,   1944,   8224
171175,21104, 0.0220471, 0.0181495, 0.0209219,   428,   143,  19413,   7879,  27292
171176,21104, 0.1306341, 0.0100267, 0.0958156,  2536,    79,  19413,   7879,  27292
171177,21104, 0.0000000, 0.0007615, 0.0002198,     0,     6,  19413,   7879,  27292
171181,21142, 0.0000000, 0.0018614, 0.0003258,     0,     9,  22787,   4835,  27622
171182,21142, 0.0055734, 0.0254395, 0.0090508,   127,   123,  22787,   4835,  27622
172152,15110, 0.0000000, 0.0123926, 0.0061365,     0,   378,  31097,  30502,  61599
172152,15032, 0.0000000, 0.0121179, 0.0086385,     0,   289,   9606,  23849,  33455
172154,15110, 0.0000000, 0.0532424, 0.0263641,     0,  1624,  31097,  30502,  61599
172155,15007, 0.0000000, 0.0660347, 0.0621392,     0,  1421,   1349,  21519,  22868
172155,15110, 0.0000000, 0.0590781, 0.0292537,     0,  1802,  31097,  30502,  61599
172155,15032, 0.0000000, 0.1581198, 0.1127186,     0,  3771,   9606,  23849,  33455
172156,15007, 0.0000000, 0.1096705, 0.1032010,     0,  2360,   1349,  21519,  22868
172157,15007, 0.6805041, 0.2525210, 0.2777681,   918,  5434,   1349,  21519,  22868
172158,15007, 0.2772424, 0.0136159, 0.0291674,   374,   293,   1349,  21519,  22868
172159,15007, 0.0000000, 0.0023235, 0.0021865,     0,    50,   1349,  21519,  22868
172160,15007, 0.0000000, 0.0031600, 0.0029736,     0,    68,   1349,  21519,  22868
172165,15118, 0.0000000, 0.0883002, 0.0226515,     0,  3800, 124724,  43035, 167759
172167,15118, 0.0729932, 0.0928082, 0.0780763,  9104,  3994, 124724,  43035, 167759
172168,15106, 0.0086831, 0.0079750, 0.0086302,  6585,   488, 758370,  61191, 819561
172169,15106, 0.0056450, 0.0565279, 0.0094441,  4281,  3459, 758370,  61191, 819561
172170,15106, 0.0247069, 0.0475233, 0.0264105, 18737,  2908, 758370,  61191, 819561
172171,15054, 0.0913014, 0.1070326, 0.0917296, 19021,   624, 208332,   5830, 214162
172171,15106, 0.0168414, 0.0165057, 0.0168163, 12772,  1010, 758370,  61191, 819561
172172,15054, 0.0784277, 0.1066895, 0.0791971, 16339,   622, 208332,   5830, 214162
172173,15054, 0.0151345, 0.2655232, 0.0219507,  3153,  1548, 208332,   5830, 214162
172174,15054, 0.0694468, 0.3910806, 0.0782025, 14468,  2280, 208332,   5830, 214162
172175,15054, 0.0016608, 0.1078902, 0.0045526,   346,   629, 208332,   5830, 214162
172176,15101, 0.0000000, 0.0003239, 0.0001132,     0,     8,  45986,  24696,  70682
172177,15019, 0.0909631, 0.0708497, 0.0887071,  2754,   271,  30276,   3825,  34101
172177,15051, 0.0000000, 0.0102067, 0.0041988,     0,   566,  79345,  55454, 134799
172177,15062, 0.0186195, 0.0866667, 0.0331527,   905,  1144,  48605,  13200,  61805
172178,15101, 0.0000000, 0.0349449, 0.0122096,     0,   863,  45986,  24696,  70682
172179,15062, 0.0806913, 0.0115152, 0.0659170,  3922,   152,  48605,  13200,  61805
172180,15062, 0.0051435, 0.0003030, 0.0041097,   250,     4,  48605,  13200,  61805
172184,9012 , 0.0000000, 0.0003327, 0.0000046,     0,     3, 641550,   9017, 650567
172185,9012 , 0.0011831, 0.1868692, 0.0037567,   759,  1685, 641550,   9017, 650567
172186,9012 , 0.0284374, 0.1250970, 0.0297771, 18244,  1128, 641550,   9017, 650567
172187,9012 , 0.0295581, 0.0099811, 0.0292868, 18963,    90, 641550,   9017, 650567
172188,9012 , 0.0158289, 0.0052124, 0.0156817, 10155,    47, 641550,   9017, 650567
172188,9013 , 0.0110399, 0.1406908, 0.0132648,  4503,  1002, 407885,   7122, 415007
172189,9013 , 0.1211101, 0.2694468, 0.1236557, 49399,  1919, 407885,   7122, 415007
172190,9013 , 0.0740895, 0.1252457, 0.0749674, 30220,   892, 407885,   7122, 415007
172191,9013 , 0.0112924, 0.1451839, 0.0135901,  4606,  1034, 407885,   7122, 415007
172191,9009 , 0.0015192, 0.0326152, 0.0054985,   173,   545, 113872,  16710, 130582
172192,9009 , 0.0000000, 0.0194494, 0.0024889,     0,   325, 113872,  16710, 130582
172192,9013 , 0.0028488, 0.0005616, 0.0028096,  1162,     4, 407885,   7122, 415007
172193,9009 , 0.1277750, 0.1155595, 0.1262119, 14550,  1931, 113872,  16710, 130582
172193,9011 , 0.0596102, 0.1268354, 0.0603472, 21240,   501, 356315,   3950, 360265
172194,9011 , 0.0410564, 0.0992405, 0.0416943, 14629,   392, 356315,   3950, 360265
172194,15122, 0.0000000, 0.1569992, 0.0005676,     0,   203, 356352,   1293, 357645
172195,9011 , 0.0095702, 0.2546836, 0.0122576,  3410,  1006, 356315,   3950, 360265
172195,15122, 0.0000000, 0.1763341, 0.0006375,     0,   228, 356352,   1293, 357645
172196,15025, 0.0704265, 0.2433636, 0.0770645, 21003,  2897, 298226,  11904, 310130
172197,15083, 0.0037280, 0.4112686, 0.2064073,    21,  2292,   5633,   5573,  11206
172197,15022, 0.0016017, 0.0680591, 0.0168012,    15,   189,   9365,   2777,  12142
172197,15025, 0.0021695, 0.0123488, 0.0025602,   647,   147, 298226,  11904, 310130
172198,15083, 0.0330197, 0.0016149, 0.0174014,   186,     9,   5633,   5573,  11206
172198,15022, 0.9325147, 0.2985236, 0.7875144,  8733,   829,   9365,   2777,  12142
172198,15025, 0.0021259, 0.0021841, 0.0021281,   634,    26, 298226,  11904, 310130
172199,15022, 0.0000000, 0.6020886, 0.1377038,     0,  1672,   9365,   2777,  12142
172199,15025, 0.0109715, 0.0054603, 0.0107600,  3272,    65, 298226,  11904, 310130
172200,15103, 0.1179506, 0.2662592, 0.1516150,  4206,  2788,  35659,  10471,  46130
172201,15103, 0.0432710, 0.0017190, 0.0338392,  1543,    18,  35659,  10471,  46130
172201,15025, 0.0000000, 0.0003360, 0.0000129,     0,     4, 298226,  11904, 310130
172202,15103, 0.2307692, 0.0026741, 0.1789941,  8229,    28,  35659,  10471,  46130
172210,21122, 0.1795329, 0.0027607, 0.1183959,  1107,     9,   6166,   3260,   9426
172211,21122, 0.1235809, 0.0015337, 0.0813707,   762,     5,   6166,   3260,   9426
172211,21048, 0.2606959, 0.0004470, 0.2296664,  4308,     1,  16525,   2237,  18762
172212,21048, 0.1932224, 0.0116227, 0.1715702,  3193,    26,  16525,   2237,  18762
172213,21074, 0.0000000, 0.0012914, 0.0003152,     0,    20,  47970,  15487,  63457
172213,21132, 0.0000000, 0.0005952, 0.0000142,     0,     2, 137752,   3360, 141112
172214,21074, 0.0576610, 0.0051011, 0.0448335,  2766,    79,  47970,  15487,  63457
172214,21132, 0.0000000, 0.0955357, 0.0022748,     0,   321, 137752,   3360, 141112
172215,21074, 0.2666667, 0.0109124, 0.2042485, 12792,   169,  47970,  15487,  63457
172215,21132, 0.0000000, 0.0059524, 0.0001417,     0,    20, 137752,   3360, 141112
172216,21074, 0.0000000, 0.0001937, 0.0000473,     0,     3,  47970,  15487,  63457
172216,29023, 0.2507576, 0.0147879, 0.1433470,  3227,   159,  12869,  10752,  23621
172217,29023, 0.0830678, 0.0299479, 0.0588883,  1069,   322,  12869,  10752,  23621
172218,29032, 0.0020951, 0.1771415, 0.0626914,    17,   761,   8114,   4296,  12410
172219,29044, 0.2199085, 0.3297872, 0.2204429,  8459,    62,  38466,    188,  38654
172219,29054, 0.3521070, 1.0000000, 0.3569871,  1763,    38,   5007,     38,   5045
172221,29059, 0.1887767, 1.0000000, 0.4259847,   841,  1841,   4455,   1841,   6296
172221,29022, 0.2378082, 0.6731858, 0.5340571,   434,  2616,   1825,   3886,   5711
172222,29017, 0.0000000, 0.1884058, 0.0013347,     0,    13,   9671,     69,   9740
172224,29028, 0.0000000, 0.0007095, 0.0000923,     0,     2,  18852,   2819,  21671
172225,29028, 0.0000000, 0.0049663, 0.0006460,     0,    14,  18852,   2819,  21671
172231,29037, 0.9238853, 0.5751029, 0.8414397,  5802,  1118,   6280,   1944,   8224
172232,21104, 0.0000000, 0.0011423, 0.0003298,     0,     9,  19413,   7879,  27292
172232,29037, 0.0595541, 0.0015432, 0.0458414,   374,     3,   6280,   1944,   8224
172233,21104, 0.0000000, 0.0016500, 0.0004763,     0,    13,  19413,   7879,  27292
172235,21104, 0.2115078, 0.0010154, 0.1507401,  4106,     8,  19413,   7879,  27292
172236,21104, 0.0000000, 0.0076152, 0.0021984,     0,    60,  19413,   7879,  27292
172236,21128, 0.0000000, 0.0015309, 0.0006183,     0,     5,   4821,   3266,   8087
172238,21096, 0.0000000, 0.1266556, 0.0581086,     0,   153,   1425,   1208,   2633
172240,21142, 0.0000000, 0.0039297, 0.0006879,     0,    19,  22787,   4835,  27622
172241,21142, 0.0000000, 0.1203723, 0.0210702,     0,   582,  22787,   4835,  27622
173211,15110, 0.0000000, 0.0043276, 0.0021429,     0,   132,  31097,  30502,  61599
173213,15032, 0.0000000, 0.0099375, 0.0070841,     0,   237,   9606,  23849,  33455
173216,15007, 0.0014826, 0.0400576, 0.0377821,     2,   862,   1349,  21519,  22868
173217,15007, 0.0407709, 0.2042846, 0.1946388,    55,  4396,   1349,  21519,  22868
173218,15007, 0.0000000, 0.0279753, 0.0263250,     0,   602,   1349,  21519,  22868
173219,15007, 0.0000000, 0.0276035, 0.0259752,     0,   594,   1349,  21519,  22868
173220,15007, 0.0000000, 0.0078535, 0.0073902,     0,   169,   1349,  21519,  22868
173223,15118, 0.0526282, 0.0044615, 0.0402721,  6564,   192, 124724,  43035, 167759
173224,15118, 0.0000000, 0.0458464, 0.0117609,     0,  1973, 124724,  43035, 167759
173225,15118, 0.1154068, 0.0179389, 0.0904035, 14394,   772, 124724,  43035, 167759
173226,15118, 0.1086319, 0.2065528, 0.1337514, 13549,  8889, 124724,  43035, 167759
173227,15118, 0.0199480, 0.0361566, 0.0241060,  2488,  1556, 124724,  43035, 167759
173228,15106, 0.0691615, 0.0060140, 0.0644467, 52450,   368, 758370,  61191, 819561
173233,15076, 0.3635040, 0.3865031, 0.3636589, 26205,   189,  72090,    489,  72579
173235,15062, 0.2067483, 0.1378030, 0.1920233, 10049,  1819,  48605,  13200,  61805
173235,15051, 0.0016258, 0.0027771, 0.0020994,   129,   154,  79345,  55454, 134799
173236,15062, 0.4678119, 0.2018182, 0.4110023, 22738,  2664,  48605,  13200,  61805
173238,15062, 0.0573192, 0.0159848, 0.0484912,  2786,   211,  48605,  13200,  61805
173242,9008 , 0.0000000, 0.0076336, 0.0000209,     0,     5, 238431,    655, 239086
173243,9008 , 0.0136643, 0.0519084, 0.0137691,  3258,    34, 238431,    655, 239086
173243,9012 , 0.0003523, 0.0013308, 0.0003658,   226,    12, 641550,   9017, 650567
173244,9012 , 0.0446091, 0.0611068, 0.0448378, 28619,   551, 641550,   9017, 650567
173245,9012 , 0.0309921, 0.0002218, 0.0305656, 19883,     2, 641550,   9017, 650567
173247,9013 , 0.0404722, 0.0338388, 0.0403584, 16508,   241, 407885,   7122, 415007
173249,9013 , 0.1461270, 0.0366470, 0.1442482, 59603,   261, 407885,   7122, 415007
173250,9013 , 0.0839697, 0.0338388, 0.0831094, 34250,   241, 407885,   7122, 415007
173251,9013 , 0.1015875, 0.0836844, 0.1012802, 41436,   596, 407885,   7122, 415007
173252,9011 , 0.1197648, 0.0868354, 0.1194038, 42674,   343, 356315,   3950, 360265
173253,15122, 0.0098891, 0.0866203, 0.0101665,  3524,   112, 356352,   1293, 357645
173254,15122, 0.0546819, 0.0061872, 0.0545066, 19486,     8, 356352,   1293, 357645
173255,15025, 0.1614313, 0.0088206, 0.1555735, 48143,   105, 298226,  11904, 310130
173256,15025, 0.0880507, 0.0037802, 0.0848160, 26259,    45, 298226,  11904, 310130
173257,15022, 0.0658836, 0.0313288, 0.0579806,   617,    87,   9365,   2777,  12142
173257,15025, 0.0535399, 0.0866935, 0.0548125, 15967,  1032, 298226,  11904, 310130
173258,15025, 0.0315734, 0.0049563, 0.0305517,  9416,    59, 298226,  11904, 310130
173259,15025, 0.0138754, 0.0155410, 0.0139393,  4138,   185, 298226,  11904, 310130
173268,21143, 0.1063952, 0.0321637, 0.0956754,  2587,   132,  24315,   4104,  28419
173269,21122, 0.2557574, 0.2300614, 0.2468704,  1577,   750,   6166,   3260,   9426
173269,21143, 0.0006169, 0.0017057, 0.0007741,    15,     7,  24315,   4104,  28419
173270,21048, 0.0000000, 0.0031292, 0.0003731,     0,     7,  16525,   2237,  18762
173270,21132, 0.0000000, 0.0065476, 0.0001559,     0,    22, 137752,   3360, 141112
173270,21122, 0.4412909, 0.7656442, 0.5534692,  2721,  2496,   6166,   3260,   9426
173271,21132, 0.0404785, 0.0068452, 0.0396777,  5576,    23, 137752,   3360, 141112
173272,21074, 0.0000000, 0.0027765, 0.0006776,     0,    43,  47970,  15487,  63457
173272,21132, 0.0643257, 0.0047619, 0.0629075,  8861,    16, 137752,   3360, 141112
173273,21132, 0.1049350, 0.0357143, 0.1032868, 14455,   120, 137752,   3360, 141112
173274,29023, 0.2097288, 0.0017671, 0.1150671,  2699,    19,  12869,  10752,  23621
173275,29023, 0.0237781, 0.6288133, 0.2991829,   306,  6761,  12869,  10752,  23621
173276,29023, 0.2447743, 0.0984003, 0.1781466,  3150,  1058,  12869,  10752,  23621
173276,29057, 0.8950951, 0.6590909, 0.8903196,  3814,    58,   4261,     88,   4349
173277,29032, 0.9651220, 0.4420391, 0.7840451,  7831,  1899,   8114,   4296,  12410
173277,29051, 0.1032999, 0.0937500, 0.1030438,   360,     9,   3485,     96,   3581
173278,29053, 0.9638104, 1.0000000, 0.9645213,  6445,   134,   6687,    134,   6821
173278,29051, 0.8967001, 0.9062500, 0.8969562,  3125,    87,   3485,     96,   3581
173279,29029, 0.8994725, 0.5608945, 0.6596669,  2899,  4389,   3223,   7825,  11048
173280,29022, 0.7621918, 0.3268142, 0.4659429,  1391,  1270,   1825,   3886,   5711
173281,29028, 0.2843200, 0.1926215, 0.2723917,  5360,   543,  18852,   2819,  21671
173282,29028, 0.0000000, 0.0003547, 0.0000461,     0,     1,  18852,   2819,  21671
173283,29028, 0.0000000, 0.0007095, 0.0000923,     0,     2,  18852,   2819,  21671
173284,29028, 0.0000000, 0.0007095, 0.0000923,     0,     2,  18852,   2819,  21671
173290,29037, 0.0165605, 0.0005144, 0.0127675,   104,     1,   6280,   1944,   8224
173290,29016, 0.0000000, 0.1600000, 0.0011780,     0,     8,   6741,     50,   6791
173291,29037, 0.0000000, 0.0015432, 0.0003648,     0,     3,   6280,   1944,   8224
173291,29016, 0.0056371, 0.0200000, 0.0057429,    38,     1,   6741,     50,   6791
173292,29037, 0.0000000, 0.3595679, 0.0849951,     0,   699,   6280,   1944,   8224
173294,21104, 0.0060784, 0.6225410, 0.1840466,   118,  4905,  19413,   7879,  27292
173294,21128, 0.0000000, 0.0137783, 0.0055645,     0,    45,   4821,   3266,   8087
173295,21128, 0.3943165, 0.0070423, 0.2379127,  1901,    23,   4821,   3266,   8087
173296,21128, 0.0000000, 0.0036742, 0.0014839,     0,    12,   4821,   3266,   8087
173297,21128, 0.0000000, 0.4678506, 0.1889452,     0,  1528,   4821,   3266,   8087
173299,21142, 0.0000000, 0.0024819, 0.0004344,     0,    12,  22787,   4835,  27622
173300,21142, 0.0000000, 0.0014478, 0.0002534,     0,     7,  22787,   4835,  27622
174270,15032, 0.0058297, 0.0763135, 0.0560753,    56,  1820,   9606,  23849,  33455
174271,15032, 0.1423069, 0.1770305, 0.1670602,  1367,  4222,   9606,  23849,  33455
174273,15032, 0.3238601, 0.0282192, 0.1131072,  3111,   673,   9606,  23849,  33455
174274,15007, 0.0000000, 0.0399182, 0.0375634,     0,   859,   1349,  21519,  22868
174274,15032, 0.0485113, 0.0602122, 0.0568525,   466,  1436,   9606,  23849,  33455
174275,15007, 0.0000000, 0.0283935, 0.0267186,     0,   611,   1349,  21519,  22868
174276,15007, 0.0000000, 0.0503276, 0.0473588,     0,  1083,   1349,  21519,  22868
174276,15111, 0.0000000, 0.0054119, 0.0047161,     0,   225,   6134,  41575,  47709
174278,15007, 0.0000000, 0.0422417, 0.0397499,     0,   909,   1349,  21519,  22868
174279,15007, 0.0000000, 0.0239323, 0.0225206,     0,   515,   1349,  21519,  22868
174279,15114, 0.0000000, 0.0096530, 0.0092615,     0,   874,   3827,  90542,  94369
174280,15005, 0.0000000, 0.0258319, 0.0154890,     0,  2287,  59119,  88534, 147653
174281,15005, 0.0000000, 0.0050376, 0.0030206,     0,   446,  59119,  88534, 147653
174281,15118, 0.0000000, 0.0053213, 0.0013651,     0,   229, 124724,  43035, 167759
174282,15118, 0.0831195, 0.2046939, 0.1143068, 10367,  8809, 124724,  43035, 167759
174283,15118, 0.0032792, 0.0290926, 0.0099011,   409,  1252, 124724,  43035, 167759
174283,15005, 0.0098784, 0.0217882, 0.0170196,   584,  1929,  59119,  88534, 147653
174284,15118, 0.0198037, 0.0184269, 0.0194505,  2470,   793, 124724,  43035, 167759
174284,15005, 0.2635193, 0.0309373, 0.1240611, 15579,  2739,  59119,  88534, 147653
174285,15118, 0.1785382, 0.0251191, 0.1391818, 22268,  1081, 124724,  43035, 167759
174286,15118, 0.1730381, 0.0423609, 0.1395156, 21582,  1823, 124724,  43035, 167759
174293,15076, 0.0512276, 0.6134970, 0.0550159,  3693,   300,  72090,    489,  72579
174293,15051, 0.2019787, 0.0447218, 0.1372859, 16026,  2480,  79345,  55454, 134799
174294,15062, 0.0000000, 0.1043182, 0.0222798,     0,  1377,  48605,  13200,  61805
174294,15051, 0.0232655, 0.0709417, 0.0428787,  1846,  3934,  79345,  55454, 134799
174295,15062, 0.0878305, 0.2927273, 0.1315913,  4269,  3864,  48605,  13200,  61805
174296,15062, 0.0000000, 0.0596212, 0.0127336,     0,   787,  48605,  13200,  61805
174297,15062, 0.0000000, 0.0087879, 0.0018769,     0,   116,  48605,  13200,  61805
174298,15062, 0.0000000, 0.0791667, 0.0169080,     0,  1045,  48605,  13200,  61805
174299,15062, 0.0000000, 0.0012879, 0.0002751,     0,    17,  48605,  13200,  61805
174299,9004 , 0.0000000, 0.1550821, 0.0023821,     0,   444, 183528,   2863, 186391
174301,9008 , 0.0000000, 0.0320611, 0.0000878,     0,    21, 238431,    655, 239086
174302,9008 , 0.0700538, 0.7236641, 0.0718444, 16703,   474, 238431,    655, 239086
174303,9008 , 0.0387408, 0.1847328, 0.0391407,  9237,   121, 238431,    655, 239086
174308,9013 , 0.0098165, 0.0001404, 0.0096504,  4004,     1, 407885,   7122, 415007
174310,9011 , 0.1160266, 0.0951899, 0.1157981, 41342,   376, 356315,   3950, 360265
174311,9011 , 0.1580764, 0.0473418, 0.1568623, 56325,   187, 356315,   3950, 360265
174312,9011 , 0.0000000, 0.0521519, 0.0005718,     0,   206, 356315,   3950, 360265
174312,15122, 0.0370504, 0.5738592, 0.0389912, 13203,   742, 356352,   1293, 357645
174315,15025, 0.1475358, 0.0057964, 0.1420953, 43999,    69, 298226,  11904, 310130
174316,15025, 0.0299303, 0.0215894, 0.0296102,  8926,   257, 298226,  11904, 310130
174327,21143, 0.0714374, 0.0706628, 0.0713255,  1737,   290,  24315,   4104,  28419
174328,21143, 0.2027966, 0.0823587, 0.1854041,  4931,   338,  24315,   4104,  28419
174329,21143, 0.2282953, 0.6401072, 0.2877652,  5551,  2627,  24315,   4104,  28419
174330,21132, 0.1111272, 0.0699405, 0.1101466, 15308,   235, 137752,   3360, 141112
174330,21143, 0.0390294, 0.1013645, 0.0480312,   949,   416,  24315,   4104,  28419
174331,21132, 0.1876561, 0.0747024, 0.1849665, 25850,   251, 137752,   3360, 141112
174332,21132, 0.0786413, 0.1583333, 0.0805389, 10833,   532, 137752,   3360, 141112
174333,29019, 0.4468736, 0.8849392, 0.4718825,  7890,   946,  17656,   1069,  18725
174334,29019, 0.0000000, 0.0065482, 0.0003738,     0,     7,  17656,   1069,  18725
174334,29023, 0.0000000, 0.0007440, 0.0003387,     0,     8,  12869,  10752,  23621
174335,29057, 0.1049049, 0.3409091, 0.1096804,   447,    30,   4261,     88,   4349
174335,29023, 0.0018649, 0.0757999, 0.0355192,    24,   815,  12869,  10752,  23621
174336,29032, 0.0000000, 0.3780261, 0.1308622,     0,  1624,   8114,   4296,  12410
174336,29049, 0.6640175, 0.0645161, 0.6603475,  3342,     2,   5033,     31,   5064
174337,29029, 0.0000000, 0.0002556, 0.0001810,     0,     2,   3223,   7825,  11048
174337,29032, 0.0000000, 0.0009311, 0.0003223,     0,     4,   8114,   4296,  12410
174338,29029, 0.0937015, 0.4388498, 0.3381608,   302,  3434,   3223,   7825,  11048
174340,29028, 0.1819966, 0.7577155, 0.2568871,  3431,  2136,  18852,   2819,  21671
174341,29028, 0.0000000, 0.0010642, 0.0001384,     0,     3,  18852,   2819,  21671
174341,29050, 0.2552242, 0.7272727, 0.2562753,  2516,    16,   9858,     22,   9880
174341,29010, 0.0106999, 0.0019342, 0.0100833,   658,     9,  61496,   4653,  66149
174348,29016, 0.0000000, 0.1400000, 0.0010308,     0,     7,   6741,     50,   6791
174349,29016, 0.1953716, 0.3800000, 0.1967310,  1317,    19,   6741,     50,   6791
174350,29016, 0.7989913, 0.2400000, 0.7948756,  5386,    12,   6741,     50,   6791
174351,21104, 0.0000000, 0.0022846, 0.0006595,     0,    18,  19413,   7879,  27292
174352,21104, 0.0000000, 0.0013961, 0.0004030,     0,    11,  19413,   7879,  27292
174353,21104, 0.0000000, 0.0151034, 0.0043603,     0,   119,  19413,   7879,  27292
174354,21128, 0.6046463, 0.0039804, 0.3620626,  2915,    13,   4821,   3266,   8087
174358,21142, 0.0000000, 0.0002068, 0.0000362,     0,     1,  22787,   4835,  27622
175330,15032, 0.2898189, 0.0199170, 0.0974144,  2784,   475,   9606,  23849,  33455
175331,15032, 0.0000000, 0.0098956, 0.0070543,     0,   236,   9606,  23849,  33455
175332,15032, 0.0000000, 0.0995849, 0.0709909,     0,  2375,   9606,  23849,  33455
175332,15111, 0.0000000, 0.0101503, 0.0088453,     0,   422,   6134,  41575,  47709
175333,15111, 0.0000000, 0.0148647, 0.0129535,     0,   618,   6134,  41575,  47709
175334,15007, 0.0000000, 0.0085971, 0.0080899,     0,   185,   1349,  21519,  22868
175334,15111, 0.0000000, 0.0208058, 0.0181308,     0,   865,   6134,  41575,  47709
175335,15007, 0.0000000, 0.0084112, 0.0079150,     0,   181,   1349,  21519,  22868
175335,15111, 0.0000000, 0.0187613, 0.0163491,     0,   780,   6134,  41575,  47709
175336,15114, 0.0000000, 0.0098297, 0.0094311,     0,   890,   3827,  90542,  94369
175337,15114, 0.0000000, 0.0062733, 0.0060189,     0,   568,   3827,  90542,  94369
175338,15005, 0.0000000, 0.0085278, 0.0051133,     0,   755,  59119,  88534, 147653
175339,15005, 0.0000000, 0.0117695, 0.0070571,     0,  1042,  59119,  88534, 147653
175340,15005, 0.0000000, 0.0443332, 0.0265826,     0,  3925,  59119,  88534, 147653
175341,15005, 0.0000000, 0.0246685, 0.0147914,     0,  2184,  59119,  88534, 147653
175342,15005, 0.0000000, 0.0159713, 0.0095765,     0,  1414,  59119,  88534, 147653
175343,15005, 0.0000000, 0.0001694, 0.0001016,     0,    15,  59119,  88534, 147653
175344,15118, 0.0564446, 0.0120135, 0.0450468,  7040,   517, 124724,  43035, 167759
175345,15118, 0.0092925, 0.0565586, 0.0214176,  1159,  2434, 124724,  43035, 167759
175345,15106, 0.0000053, 0.0596820, 0.0044609,     4,  3652, 758370,  61191, 819561
175346,15106, 0.0127893, 0.0331421, 0.0143089,  9699,  2028, 758370,  61191, 819561
175347,15106, 0.0376782, 0.0036607, 0.0351383, 28574,   224, 758370,  61191, 819561
175351,15051, 0.0782658, 0.0015508, 0.0467066,  6210,    86,  79345,  55454, 134799
175351,15106, 0.0113981, 0.0137275, 0.0115720,  8644,   840, 758370,  61191, 819561
175353,15051, 0.0264793, 0.0240019, 0.0254601,  2101,  1331,  79345,  55454, 134799
175354,15051, 0.2213876, 0.0294478, 0.1424269, 17566,  1633,  79345,  55454, 134799
175355,15051, 0.0000126, 0.0070329, 0.0029006,     1,   390,  79345,  55454, 134799
175356,15051, 0.0000000, 0.0281134, 0.0115654,     0,  1559,  79345,  55454, 134799
175357,15037, 0.0000000, 0.0201373, 0.0025189,     0,   610, 211875,  30292, 242167
175358,9004 , 0.0518776, 0.0115264, 0.0512578,  9521,    33, 183528,   2863, 186391
175359,9004 , 0.0353570, 0.2046804, 0.0379578,  6489,   586, 183528,   2863, 186391
175360,9010 , 0.0129138, 0.0405405, 0.0129279,  9384,    15, 726664,    370, 727034
175360,9004 , 0.0080533, 0.1809291, 0.0107087,  1478,   518, 183528,   2863, 186391
175361,9010 , 0.0472529, 0.9594595, 0.0477172, 34337,   355, 726664,    370, 727034
175369,9011 , 0.1460477, 0.0308861, 0.1447851, 52039,   122, 356315,   3950, 360265
175370,9011 , 0.0140971, 0.0065823, 0.0140147,  5023,    26, 356315,   3950, 360265
175371,9011 , 0.0255055, 0.0215190, 0.0254618,  9088,    85, 356315,   3950, 360265
175374,15025, 0.0000671, 0.0078125, 0.0003644,    20,    93, 298226,  11904, 310130
175374,15039, 0.1386983, 0.0894126, 0.1378078, 63651,   755, 458917,   8444, 467361
175375,15025, 0.0390174, 0.0062164, 0.0377584, 11636,    74, 298226,  11904, 310130
175375,15039, 0.1211199, 0.0580294, 0.1199801, 55584,   490, 458917,   8444, 467361
175376,15039, 0.0544761, 0.0365940, 0.0541530, 25000,   309, 458917,   8444, 467361
175377,15039, 0.0000000, 0.0010658, 0.0000193,     0,     9, 458917,   8444, 467361
175386,21180, 0.2845582, 0.0007482, 0.2014623,  7349,     8,  25826,  10692,  36518
175387,21143, 0.0000000, 0.0026803, 0.0003871,     0,    11,  24315,   4104,  28419
175388,21143, 0.2462266, 0.0560429, 0.2187621,  5987,   230,  24315,   4104,  28419
175389,21132, 0.2071476, 0.0428571, 0.2032357, 28535,   144, 137752,   3360, 141112
175390,21132, 0.1858412, 0.4122024, 0.1912311, 25600,  1385, 137752,   3360, 141112
175391,21132, 0.0047694, 0.0836309, 0.0066472,   657,   281, 137752,   3360, 141112
175391,29019, 0.4165156, 0.1075772, 0.3988785,  7354,   115,  17656,   1069,  18725
175392,29019, 0.0000000, 0.0009355, 0.0000534,     0,     1,  17656,   1069,  18725
175392,29015, 0.0696944, 0.0030024, 0.0501109,  1731,    31,  24837,  10325,  35162
175393,29056, 0.7978972, 1.0000000, 0.7981625,  5464,     9,   6848,      9,   6857
175393,29015, 0.1220357, 0.0002906, 0.0862863,  3031,     3,  24837,  10325,  35162
175394,29023, 0.1860284, 0.0008371, 0.1017315,  2394,     9,  12869,  10752,  23621
175394,29049, 0.0000000, 0.9354839, 0.0057267,     0,    29,   5033,     31,   5064
175399,29010, 0.0999415, 0.0178380, 0.0941662,  6146,    83,  61496,   4653,  66149
175400,29010, 0.0851600, 0.0159037, 0.0802884,  5237,    74,  61496,   4653,  66149
175401,29010, 0.0000000, 0.4304750, 0.0302801,     0,  2003,  61496,   4653,  66149
175403,29050, 0.0000000, 0.2727273, 0.0006073,     0,     6,   9858,     22,   9880
175406,29013, 0.0047389, 0.0269384, 0.0088022,   329,   419,  69425,  15554,  84979
175407,29013, 0.0009363, 0.0822939, 0.0158274,    65,  1280,  69425,  15554,  84979
175408,29013, 0.1016493, 0.0004500, 0.0831264,  7057,     7,  69425,  15554,  84979
175408,29016, 0.0000000, 0.0600000, 0.0004418,     0,     3,   6741,     50,   6791
175410,21104, 0.0000000, 0.0007615, 0.0002198,     0,     6,  19413,   7879,  27292
175410,29013, 0.0000000, 0.0060435, 0.0011062,     0,    94,  69425,  15554,  84979
175413,21128, 0.0000000, 0.1065524, 0.0430320,     0,   348,   4821,   3266,   8087
175414,21128, 0.0000000, 0.0006124, 0.0002473,     0,     2,   4821,   3266,   8087
175415,21128, 0.0000000, 0.0012247, 0.0004946,     0,     4,   4821,   3266,   8087
175416,21128, 0.0000000, 0.3101653, 0.1252628,     0,  1013,   4821,   3266,   8087
176388,15111, 0.0000000, 0.0335298, 0.0292188,     0,  1394,   6134,  41575,  47709
176389,15111, 0.0000000, 0.0403608, 0.0351716,     0,  1678,   6134,  41575,  47709
176390,15111, 0.0000000, 0.0034155, 0.0029764,     0,   142,   6134,  41575,  47709
176392,15111, 0.0000000, 0.0570054, 0.0496762,     0,  2370,   6134,  41575,  47709
176393,15111, 0.0000000, 0.0058208, 0.0050724,     0,   242,   6134,  41575,  47709
176394,15114, 0.0000000, 0.0098960, 0.0094946,     0,   896,   3827,  90542,  94369
176396,15114, 0.0000000, 0.0206865, 0.0198476,     0,  1873,   3827,  90542,  94369
176397,15114, 0.0000000, 0.0129553, 0.0124299,     0,  1173,   3827,  90542,  94369
176397,15005, 0.0000000, 0.0089005, 0.0053368,     0,   788,  59119,  88534, 147653
176398,15005, 0.0000000, 0.0109337, 0.0065559,     0,   968,  59119,  88534, 147653
176399,15005, 0.0000000, 0.0029254, 0.0017541,     0,   259,  59119,  88534, 147653
176400,15005, 0.0001353, 0.0133960, 0.0080865,     8,  1186,  59119,  88534, 147653
176401,15005, 0.0385494, 0.0303838, 0.0336532,  2279,  2690,  59119,  88534, 147653
176402,15005, 0.0196891, 0.0676802, 0.0484650,  1164,  5992,  59119,  88534, 147653
176403,15005, 0.2229063, 0.0040549, 0.0916812, 13178,   359,  59119,  88534, 147653
176404,15106, 0.0000000, 0.0482914, 0.0036056,     0,  2955, 758370,  61191, 819561
176405,15106, 0.0082058, 0.1106372, 0.0158536,  6223,  6770, 758370,  61191, 819561
176406,15106, 0.0344106, 0.0044941, 0.0321770, 26096,   275, 758370,  61191, 819561
176409,15106, 0.0081029, 0.0286807, 0.0096393,  6145,  1755, 758370,  61191, 819561
176410,15106, 0.0064388, 0.0524260, 0.0098724,  4883,  3208, 758370,  61191, 819561
176411,15051, 0.0000000, 0.0004328, 0.0001780,     0,    24,  79345,  55454, 134799
176412,15051, 0.0373811, 0.0447218, 0.0404009,  2966,  2480,  79345,  55454, 134799
176413,15051, 0.0660533, 0.0026689, 0.0399780,  5241,   148,  79345,  55454, 134799
176415,15037, 0.0000000, 0.0236036, 0.0029525,     0,   715, 211875,  30292, 242167
176416,15037, 0.0030395, 0.1461442, 0.0209401,   644,  4427, 211875,  30292, 242167
176417,15037, 0.0314808, 0.1460452, 0.0458114,  6670,  4424, 211875,  30292, 242167
176418,9004 , 0.1507781, 0.2420538, 0.1521801, 27672,   693, 183528,   2863, 186391
176430,9011 , 0.0013331, 0.1498734, 0.0029617,   475,   592, 356315,   3950, 360265
176432,15039, 0.0871639, 0.0908337, 0.0872302, 40001,   767, 458917,   8444, 467361
176433,15039, 0.1208846, 0.0005921, 0.1187112, 55476,     5, 458917,   8444, 467361
176434,15039, 0.0628981, 0.3779015, 0.0685894, 28865,  3191, 458917,   8444, 467361
176435,15039, 0.0000000, 0.0260540, 0.0004707,     0,   220, 458917,   8444, 467361
176436,15039, 0.0000000, 0.0143297, 0.0002589,     0,   121, 458917,   8444, 467361
176439,15039, 0.0000000, 0.0288963, 0.0005221,     0,   244, 458917,   8444, 467361
176443,21180, 0.1152327, 0.0014029, 0.0819048,  2976,    15,  25826,  10692,  36518
176444,21180, 0.1611167, 0.0034605, 0.1149570,  4161,    37,  25826,  10692,  36518
176445,21134, 0.0000000, 0.0127701, 0.0033661,     0,    65,  14220,   5090,  19310
176445,21180, 0.0000000, 0.0103816, 0.0030396,     0,   111,  25826,  10692,  36518
176446,21134, 0.4541491, 0.1996071, 0.3870533,  6458,  1016,  14220,   5090,  19310
176447,21134, 0.3238397, 0.0937132, 0.2631797,  4605,   477,  14220,   5090,  19310
176447,21143, 0.0475427, 0.0129142, 0.0425420,  1156,    53,  24315,   4104,  28419
176448,21132, 0.0006969, 0.0023810, 0.0007370,    96,     8, 137752,   3360, 141112
176449,29015, 0.0000000, 0.0005811, 0.0001706,     0,     6,  24837,  10325,  35162
176450,29015, 0.0290293, 0.1228087, 0.0565667,   721,  1268,  24837,  10325,  35162
176451,29015, 0.3216572, 0.0070702, 0.2292816,  7989,    73,  24837,  10325,  35162
176452,29015, 0.1547288, 0.4096852, 0.2295944,  3843,  4230,  24837,  10325,  35162
176453,29024, 0.3025015, 0.2963565, 0.2999443,  4438,  3099,  14671,  10457,  25128
176453,29015, 0.0444901, 0.0007748, 0.0316535,  1105,     8,  24837,  10325,  35162
176454,29024, 0.3034558, 0.2284594, 0.2722461,  4452,  2389,  14671,  10457,  25128
176455,29036, 0.7295306, 0.1243642, 0.4468848,  8019,  1198,  10992,   9633,  20625
176456,29036, 0.2233443, 0.3105990, 0.2640970,  2455,  2992,  10992,   9633,  20625
176458,29010, 0.1620756, 0.0133247, 0.1516123,  9967,    62,  61496,   4653,  66149
176459,29010, 0.0001138, 0.5203094, 0.0367050,     7,  2421,  61496,   4653,  66149
176459,29018, 0.1199828, 0.2780278, 0.1420020,  3623,  1359,  30196,   4888,  35084
176460,29018, 0.0401378, 0.7176759, 0.1345343,  1212,  3508,  30196,   4888,  35084
176460,29010, 0.0000000, 0.0002149, 0.0000151,     0,     1,  61496,   4653,  66149
176460,29026, 0.0664804, 0.0009978, 0.0518700,   928,     4,  13959,   4009,  17968
176461,29052, 0.0000000, 0.0215054, 0.0010601,     0,     6,   5381,    279,   5660
176462,29052, 0.1027690, 0.2114695, 0.1081272,   553,    59,   5381,    279,   5660
176463,29052, 0.0000000, 0.0071685, 0.0003534,     0,     2,   5381,    279,   5660
176463,29013, 0.0000000, 0.0006429, 0.0001177,     0,    10,  69425,  15554,  84979
176465,29013, 0.0029816, 0.0798508, 0.0170513,   207,  1242,  69425,  15554,  84979
176466,29013, 0.2622542, 0.0012216, 0.2144765, 18207,    19,  69425,  15554,  84979
176467,29013, 0.3685992, 0.0019931, 0.3014980, 25590,    31,  69425,  15554,  84979
176468,29013, 0.0012820, 0.0050791, 0.0019770,    89,    79,  69425,  15554,  84979
176469,29013, 0.0000000, 0.0146586, 0.0026830,     0,   228,  69425,  15554,  84979
176470,21128, 0.0000000, 0.0018371, 0.0007419,     0,     6,   4821,   3266,   8087
176470,29013, 0.0000000, 0.0307316, 0.0056249,     0,   478,  69425,  15554,  84979
176470,29008, 0.0000000, 0.0100512, 0.0038768,     0,    53,   8398,   5273,  13671
176472,29008, 0.8530602, 0.0037929, 0.5254919,  7164,    20,   8398,   5273,  13671
176473,21128, 0.0000000, 0.0814452, 0.0328923,     0,   266,   4821,   3266,   8087
176473,29008, 0.0054775, 0.1270624, 0.0523736,    46,   670,   8398,   5273,  13671
176474,29007, 0.0000000, 0.0866845, 0.0063118,     0,    97,  14249,   1119,  15368
176475,21128, 0.0000000, 0.0003062, 0.0001237,     0,     1,   4821,   3266,   8087
176475,29007, 0.0487754, 0.1671135, 0.0573920,   695,   187,  14249,   1119,  15368
177447,15111, 0.0000000, 0.0499098, 0.0434928,     0,  2075,   6134,  41575,  47709
177448,15111, 0.2207369, 0.0525556, 0.0741789,  1354,  2185,   6134,  41575,  47709
177449,15111, 0.3518096, 0.0068551, 0.0512063,  2158,   285,   6134,  41575,  47709
177450,15111, 0.1415064, 0.0567168, 0.0676183,   868,  2358,   6134,  41575,  47709
177451,15111, 0.0000000, 0.0016356, 0.0014253,     0,    68,   6134,  41575,  47709
177452,15111, 0.0000000, 0.0051714, 0.0045065,     0,   215,   6134,  41575,  47709
177452,15114, 0.0000000, 0.0068035, 0.0065276,     0,   616,   3827,  90542,  94369
177453,15114, 0.0000000, 0.0042743, 0.0041009,     0,   387,   3827,  90542,  94369
177454,15114, 0.0000000, 0.0283183, 0.0271699,     0,  2564,   3827,  90542,  94369
177455,15114, 0.0000000, 0.0070685, 0.0067819,     0,   640,   3827,  90542,  94369
177456,15114, 0.0000000, 0.0131320, 0.0125995,     0,  1189,   3827,  90542,  94369
177456,15005, 0.0000000, 0.0024623, 0.0014764,     0,   218,  59119,  88534, 147653
177457,15114, 0.0000000, 0.0023304, 0.0022359,     0,   211,   3827,  90542,  94369
177457,15005, 0.0000000, 0.0243635, 0.0146086,     0,  2157,  59119,  88534, 147653
177459,15005, 0.0000000, 0.0368107, 0.0220720,     0,  3259,  59119,  88534, 147653
177460,15005, 0.0148514, 0.0252784, 0.0211035,   878,  2238,  59119,  88534, 147653
177461,15005, 0.1169336, 0.0468634, 0.0749189,  6913,  4149,  59119,  88534, 147653
177462,15005, 0.1620122, 0.0253801, 0.0800864,  9578,  2247,  59119,  88534, 147653
177463,15106, 0.0002848, 0.0266052, 0.0022500,   216,  1628, 758370,  61191, 819561
177464,15106, 0.0016535, 0.1068458, 0.0095075,  1254,  6538, 758370,  61191, 819561
177465,15106, 0.0130477, 0.0330768, 0.0145432,  9895,  2024, 758370,  61191, 819561
177466,15106, 0.0195287, 0.0735566, 0.0235626, 14810,  4501, 758370,  61191, 819561
177466,15067, 0.0001785, 0.0013613, 0.0007678,     7,    53,  39213,  38933,  78146
177467,15106, 0.0179464, 0.0293834, 0.0188003, 13610,  1798, 758370,  61191, 819561
177468,15106, 0.0159342, 0.0104917, 0.0155278, 12084,   642, 758370,  61191, 819561
177469,15106, 0.0016417, 0.0030887, 0.0017497,  1245,   189, 758370,  61191, 819561
177469,15051, 0.0000000, 0.0444152, 0.0182716,     0,  2463,  79345,  55454, 134799
177470,15051, 0.0007436, 0.0203953, 0.0088280,    59,  1131,  79345,  55454, 134799
177471,15051, 0.0880081, 0.0105673, 0.0561503,  6983,   586,  79345,  55454, 134799
177472,15051, 0.0422207, 0.0052837, 0.0270254,  3350,   293,  79345,  55454, 134799
177473,15051, 0.0033146, 0.0408627, 0.0187613,   263,  2266,  79345,  55454, 134799
177474,15037, 0.0000000, 0.0003631, 0.0000454,     0,    11, 211875,  30292, 242167
177474,15051, 0.0000000, 0.0002525, 0.0001039,     0,    14,  79345,  55454, 134799
177475,15037, 0.0206065, 0.0995312, 0.0304790,  4366,  3015, 211875,  30292, 242167
177476,15037, 0.0786029, 0.1317510, 0.0852511, 16654,  3991, 211875,  30292, 242167
177477,15037, 0.0292012, 0.0752674, 0.0349635,  6187,  2280, 211875,  30292, 242167
177477,9004 , 0.0724358, 0.2057283, 0.0744832, 13294,   589, 183528,   2863, 186391
177490,15070, 0.2266143, 0.2200000, 0.2265635, 57083,   429, 251895,   1950, 253845
177491,15070, 0.0073126, 0.7800000, 0.0132482,  1842,  1521, 251895,   1950, 253845
177492,15039, 0.0000000, 0.0093558, 0.0001690,     0,    79, 458917,   8444, 467361
177493,15039, 0.0206312, 0.1308621, 0.0226228,  9468,  1105, 458917,   8444, 467361
177494,15039, 0.0033100, 0.0120796, 0.0034684,  1519,   102, 458917,   8444, 467361
177500,15039, 0.0037763, 0.0139744, 0.0039605,  1733,   118, 458917,   8444, 467361
177501,21180, 0.0000000, 0.0130004, 0.0038063,     0,   139,  25826,  10692,  36518
177502,21180, 0.0116936, 0.0214179, 0.0145408,   302,   229,  25826,  10692,  36518
177503,21180, 0.0376752, 0.2758137, 0.1073991,   973,  2949,  25826,  10692,  36518
177504,21180, 0.1091923, 0.0053311, 0.0787831,  2820,    57,  25826,  10692,  36518
177505,21134, 0.1310830, 0.0111984, 0.0994821,  1864,    57,  14220,   5090,  19310
177506,21134, 0.0000000, 0.2738703, 0.0721906,     0,  1394,  14220,   5090,  19310
177507,29015, 0.0050328, 0.0106538, 0.0066834,   125,   110,  24837,  10325,  35162
177508,29015, 0.0000000, 0.0676998, 0.0198794,     0,   699,  24837,  10325,  35162
177509,29015, 0.0000000, 0.0338983, 0.0099539,     0,   350,  24837,  10325,  35162
177511,29015, 0.0000000, 0.0123971, 0.0036403,     0,   128,  24837,  10325,  35162
177512,29015, 0.0707815, 0.0558838, 0.0664069,  1758,   577,  24837,  10325,  35162
177512,29024, 0.0000000, 0.0123362, 0.0051337,     0,   129,  14671,  10457,  25128
177513,29024, 0.0000000, 0.2161232, 0.0899395,     0,  2260,  14671,  10457,  25128
177514,29036, 0.0006368, 0.2435378, 0.1140848,     7,  2346,  10992,   9633,  20625
177514,29024, 0.0000000, 0.0829110, 0.0345033,     0,   867,  14671,  10457,  25128
177515,29036, 0.0000000, 0.3214990, 0.1501576,     0,  3097,  10992,   9633,  20625
177515,29033, 0.0423420, 0.2307692, 0.0423966,  3801,     6,  89769,     26,  89795
177516,29002, 0.6418756, 0.9023543, 0.6923883,  6913,  2338,  10770,   2591,  13361
177518,29018, 0.0303683, 0.0042962, 0.0267358,   917,    21,  30196,   4888,  35084
177518,29026, 0.1871194, 0.9099526, 0.3483971,  2612,  3648,  13959,   4009,  17968
177519,29026, 0.1901999, 0.0548765, 0.1600067,  2655,   220,  13959,   4009,  17968
177519,29009, 0.2079855, 0.5651233, 0.3709041,   573,  1306,   2755,   2311,   5066
177520,29052, 0.2003345, 0.7598566, 0.2279152,  1078,   212,   5381,    279,   5660
177520,29009, 0.3818512, 0.3072263, 0.3478089,  1052,   710,   2755,   2311,   5066
177521,29009, 0.0000000, 0.1276504, 0.0582313,     0,   295,   2755,   2311,   5066
177522,29013, 0.0000000, 0.0010287, 0.0001883,     0,    16,  69425,  15554,  84979
177523,29013, 0.0000000, 0.0898804, 0.0164511,     0,  1398,  69425,  15554,  84979
177524,29013, 0.0000000, 0.1362993, 0.0249473,     0,  2120,  69425,  15554,  84979
177525,29013, 0.0336046, 0.0010287, 0.0276421,  2333,    16,  69425,  15554,  84979
177526,29013, 0.0714728, 0.0066221, 0.0596030,  4962,   103,  69425,  15554,  84979
177527,29013, 0.0010515, 0.0016716, 0.0011650,    73,    26,  69425,  15554,  84979
177528,29013, 0.0000000, 0.0007072, 0.0001294,     0,    11,  69425,  15554,  84979
177529,29013, 0.0055167, 0.0007072, 0.0046364,   383,    11,  69425,  15554,  84979
177530,29008, 0.0000000, 0.0001896, 0.0000731,     0,     1,   8398,   5273,  13671
177531,29008, 0.0000000, 0.0443770, 0.0171165,     0,   234,   8398,   5273,  13671
177532,29008, 0.0000000, 0.0584108, 0.0225294,     0,   308,   8398,   5273,  13671
177532,29004, 0.0000000, 0.0237014, 0.0180107,     0,   287,   3826,  12109,  15935
177533,29008, 0.0000000, 0.1957140, 0.0754883,     0,  1032,   8398,   5273,  13671
177533,29007, 0.0000000, 0.2555853, 0.0186101,     0,   286,  14249,   1119,  15368
177536,21108, 0.0000000, 0.0036265, 0.0014480,     0,    24,   9957,   6618,  16575
178506,15111, 0.0000000, 0.0331930, 0.0289254,     0,  1380,   6134,  41575,  47709
178507,15111, 0.0000000, 0.0476729, 0.0415435,     0,  1982,   6134,  41575,  47709
178508,15111, 0.0498859, 0.0248226, 0.0280450,   306,  1032,   6134,  41575,  47709
178509,15111, 0.0000000, 0.1147324, 0.0999811,     0,  4770,   6134,  41575,  47709
178510,15111, 0.0000000, 0.0360553, 0.0314196,     0,  1499,   6134,  41575,  47709
178510,15114, 0.0000000, 0.0106691, 0.0102364,     0,   966,   3827,  90542,  94369
178511,15114, 0.0000000, 0.0085596, 0.0082124,     0,   775,   3827,  90542,  94369
178512,15114, 0.0000000, 0.0142365, 0.0136591,     0,  1289,   3827,  90542,  94369
178513,15114, 0.0000000, 0.0279097, 0.0267779,     0,  2527,   3827,  90542,  94369
178514,15114, 0.0000000, 0.0191403, 0.0183641,     0,  1733,   3827,  90542,  94369
178515,15114, 0.0000000, 0.0338186, 0.0324471,     0,  3062,   3827,  90542,  94369
178517,15005, 0.0000000, 0.0348906, 0.0209207,     0,  3089,  59119,  88534, 147653
178518,15005, 0.0000000, 0.0147853, 0.0088654,     0,  1309,  59119,  88534, 147653
178519,15005, 0.0000000, 0.0024059, 0.0014426,     0,   213,  59119,  88534, 147653
178520,15005, 0.0000000, 0.0228161, 0.0136807,     0,  2020,  59119,  88534, 147653
178521,15005, 0.0000000, 0.0616486, 0.0369650,     0,  5458,  59119,  88534, 147653
178522,15106, 0.0040350, 0.0275531, 0.0057909,  3060,  1686, 758370,  61191, 819561
178523,15106, 0.0014782, 0.0371787, 0.0041437,  1121,  2275, 758370,  61191, 819561
178524,15106, 0.0034258, 0.0540929, 0.0072087,  2598,  3310, 758370,  61191, 819561
178525,15087, 0.0000000, 0.0478707, 0.0283746,     0,  2554,  36658,  53352,  90010
178525,15067, 0.0342233, 0.0533481, 0.0437514,  1342,  2077,  39213,  38933,  78146
178526,15067, 0.0460052, 0.0414045, 0.0437130,  1804,  1612,  39213,  38933,  78146
178526,15087, 0.0000000, 0.0005998, 0.0003555,     0,    32,  36658,  53352,  90010
178527,15067, 0.1258511, 0.0180310, 0.0721342,  4935,   702,  39213,  38933,  78146
178527,15087, 0.0705712, 0.0427163, 0.0540607,  2587,  2279,  36658,  53352,  90010
178528,15051, 0.0000000, 0.0128214, 0.0052745,     0,   711,  79345,  55454, 134799
178528,15115, 0.1922709, 0.0038680, 0.1312944,  6025,    58,  31336,  14995,  46331
178529,15051, 0.0000000, 0.0979190, 0.0402822,     0,  5430,  79345,  55454, 134799
178530,15051, 0.0007814, 0.1787427, 0.0739916,    62,  9912,  79345,  55454, 134799
178531,15051, 0.0000000, 0.2479352, 0.1019963,     0, 13749,  79345,  55454, 134799
178532,15051, 0.0000000, 0.0000180, 0.0000074,     0,     1,  79345,  55454, 134799
178534,15037, 0.0129746, 0.0049848, 0.0119752,  2749,   151, 211875,  30292, 242167
178535,15037, 0.0165522, 0.0476363, 0.0204404,  3507,  1443, 211875,  30292, 242167
178536,15037, 0.0583646, 0.1382873, 0.0683619, 12366,  4189, 211875,  30292, 242167
178549,15031, 0.0563602, 0.1207730, 0.0565771, 34514,   250, 612383,   2070, 614453
178550,15029, 0.0266946, 0.0074977, 0.0264606,  4616,    16, 172919,   2134, 175053
178551,15029, 0.0009137, 0.0820056, 0.0019023,   158,   175, 172919,   2134, 175053
178552,15039, 0.0139132, 0.0448839, 0.0144728,  6385,   379, 458917,   8444, 467361
178552,15029, 0.0000000, 0.0421743, 0.0005141,     0,    90, 172919,   2134, 175053
178553,15039, 0.0053517, 0.0630033, 0.0063933,  2456,   532, 458917,   8444, 467361
178554,15039, 0.0000000, 0.0021317, 0.0000385,     0,    18, 458917,   8444, 467361
178560,21180, 0.0000000, 0.1050318, 0.0307520,     0,  1123,  25826,  10692,  36518
178561,21180, 0.0000000, 0.1834082, 0.0536995,     0,  1961,  25826,  10692,  36518
178562,21180, 0.0000000, 0.0171156, 0.0050112,     0,   183,  25826,  10692,  36518
178563,21180, 0.1205762, 0.1205574, 0.1205707,  3114,  1289,  25826,  10692,  36518
178564,21134, 0.0002110, 0.0972495, 0.0257897,     3,   495,  14220,   5090,  19310
178564,21180, 0.0015875, 0.0004676, 0.0012597,    41,     5,  25826,  10692,  36518
178565,21134, 0.0000000, 0.3115914, 0.0821336,     0,  1586,  14220,   5090,  19310
178565,29015, 0.0272980, 0.0000969, 0.0193106,   678,     1,  24837,  10325,  35162
178566,29015, 0.1352015, 0.0024213, 0.0962118,  3358,    25,  24837,  10325,  35162
178567,29015, 0.0000000, 0.0987893, 0.0290086,     0,  1020,  24837,  10325,  35162
178569,29015, 0.0000000, 0.0535593, 0.0157272,     0,   553,  24837,  10325,  35162
178570,29015, 0.0000000, 0.0323487, 0.0094989,     0,   334,  24837,  10325,  35162
178572,29024, 0.0676845, 0.1619968, 0.1069325,   993,  1694,  14671,  10457,  25128
178574,29033, 0.0000000, 0.7692308, 0.0002227,     0,    20,  89769,     26,  89795
178574,29001, 0.0000000, 0.9894875, 0.0762532,     0,   753,   9114,    761,   9875
178574,29040, 0.0000000, 0.1507594, 0.0964509,     0,   943,   3522,   6255,   9777
178575,29002, 0.0031569, 0.0976457, 0.0214804,    34,   253,  10770,   2591,  13361
178575,29001, 0.0059250, 0.0105125, 0.0062785,    54,     8,   9114,    761,   9875
178575,29040, 0.0000000, 0.0006395, 0.0004091,     0,     4,   3522,   6255,   9777
178575,29043, 0.0180991, 0.0012102, 0.0155678,   509,     6,  28123,   4958,  33081
178576,29043, 0.0646090, 0.1399758, 0.0759046,  1817,   694,  28123,   4958,  33081
178577,29026, 0.3909306, 0.0341731, 0.3113312,  5457,   137,  13959,   4009,  17968
178579,29038, 0.1321873, 0.8165905, 0.2552871,  1584,  2146,  11983,   2628,  14611
178580,29038, 0.0000000, 0.1035008, 0.0186161,     0,   272,  11983,   2628,  14611
178581,29035, 0.1121495, 1.0000000, 0.1161210,   624,    25,   5564,     25,   5589
178582,29013, 0.0000000, 0.0830012, 0.0151920,     0,  1291,  69425,  15554,  84979
178583,29013, 0.0000000, 0.0097724, 0.0017887,     0,   152,  69425,  15554,  84979
178584,29013, 0.0000000, 0.0230809, 0.0042246,     0,   359,  69425,  15554,  84979
178585,29013, 0.0605113, 0.0005143, 0.0495299,  4201,     8,  69425,  15554,  84979
178586,29013, 0.0000000, 0.0463546, 0.0084844,     0,   721,  69425,  15554,  84979
178587,29013, 0.0000000, 0.0039218, 0.0007178,     0,    61,  69425,  15554,  84979
178587,29008, 0.0000000, 0.0058790, 0.0022676,     0,    31,   8398,   5273,  13671
178588,29013, 0.0774649, 0.0012216, 0.0635098,  5378,    19,  69425,  15554,  84979
178588,29008, 0.0000000, 0.0259814, 0.0100212,     0,   137,   8398,   5273,  13671
178589,29008, 0.0000000, 0.3210696, 0.1238388,     0,  1693,   8398,   5273,  13671
178589,29004, 0.0000000, 0.0055331, 0.0042046,     0,    67,   3826,  12109,  15935
178590,29008, 0.0000000, 0.0614451, 0.0236998,     0,   324,   8398,   5273,  13671
178590,29004, 0.0000000, 0.0468247, 0.0355821,     0,   567,   3826,  12109,  15935
178591,29008, 0.0000000, 0.0003793, 0.0001463,     0,     2,   8398,   5273,  13671
178592,29008, 0.0000000, 0.1122701, 0.0433033,     0,   592,   8398,   5273,  13671
178593,29007, 0.0000000, 0.4906166, 0.0357236,     0,   549,  14249,   1119,  15368
178594,21108, 0.0000000, 0.1063766, 0.0424736,     0,   704,   9957,   6618,  16575
178595,21108, 0.0000000, 0.0146570, 0.0058522,     0,    97,   9957,   6618,  16575
179565,15111, 0.0000000, 0.0087312, 0.0076086,     0,   363,   6134,  41575,  47709
179566,15111, 0.0000000, 0.0016115, 0.0014043,     0,    67,   6134,  41575,  47709
179567,15111, 0.0000000, 0.0630186, 0.0549163,     0,  2620,   6134,  41575,  47709
179568,15111, 0.2360613, 0.0436801, 0.0684148,  1448,  1816,   6134,  41575,  47709
179570,15114, 0.0000000, 0.0137063, 0.0131505,     0,  1241,   3827,  90542,  94369
179571,15114, 1.0000000, 0.0345585, 0.0737107,  3827,  3129,   3827,  90542,  94369
179572,15114, 0.0000000, 0.0192949, 0.0185124,     0,  1747,   3827,  90542,  94369
179573,15114, 0.0000000, 0.0065826, 0.0063156,     0,   596,   3827,  90542,  94369
179574,15114, 0.0000000, 0.0275342, 0.0264176,     0,  2493,   3827,  90542,  94369
179575,15114, 0.0000000, 0.0046498, 0.0044612,     0,   421,   3827,  90542,  94369
179576,15114, 0.0000000, 0.0034790, 0.0033380,     0,   315,   3827,  90542,  94369
179577,15005, 0.0000000, 0.0204893, 0.0122856,     0,  1814,  59119,  88534, 147653
179578,15005, 0.0000000, 0.0258206, 0.0154822,     0,  2286,  59119,  88534, 147653
179580,15005, 0.0000000, 0.0251090, 0.0150556,     0,  2223,  59119,  88534, 147653
179582,15106, 0.0000000, 0.0109493, 0.0008175,     0,   670, 758370,  61191, 819561
179583,15106, 0.0000000, 0.0226504, 0.0016911,     0,  1386, 758370,  61191, 819561
179584,15087, 0.0000000, 0.0706628, 0.0418842,     0,  3770,  36658,  53352,  90010
179584,15106, 0.0000000, 0.0138746, 0.0010359,     0,   849, 758370,  61191, 819561
179585,15087, 0.0080474, 0.0849640, 0.0536385,   295,  4533,  36658,  53352,  90010
179586,15067, 0.2242369, 0.1554979, 0.1899905,  8793,  6054,  39213,  38933,  78146
179586,15087, 0.1421518, 0.0084720, 0.0629152,  5211,   452,  36658,  53352,  90010
179587,15067, 0.1394691, 0.2113631, 0.1752873,  5469,  8229,  39213,  38933,  78146
179588,15115, 0.1255744, 0.0837613, 0.1120416,  3935,  1256,  31336,  14995,  46331
179588,15067, 0.0000000, 0.0918244, 0.0457477,     0,  3575,  39213,  38933,  78146
179589,15115, 0.2372990, 0.2442147, 0.2395372,  7436,  3662,  31336,  14995,  46331
179590,15051, 0.0000000, 0.0356692, 0.0146737,     0,  1978,  79345,  55454, 134799
179590,15115, 0.0000000, 0.2427476, 0.0785651,     0,  3640,  31336,  14995,  46331
179591,15051, 0.0000000, 0.0108558, 0.0044659,     0,   602,  79345,  55454, 134799
179591,15115, 0.0000000, 0.0326109, 0.0105545,     0,   489,  31336,  14995,  46331
179592,15037, 0.0000000, 0.0422224, 0.0052815,     0,  1279, 211875,  30292, 242167
179592,15051, 0.0000000, 0.0276445, 0.0113725,     0,  1533,  79345,  55454, 134799
179592,15057, 0.0000000, 0.0479059, 0.0014021,     0,  1169, 809377,  24402, 833779
179593,15037, 0.0019823, 0.0419583, 0.0069828,   420,  1271, 211875,  30292, 242167
179593,15057, 0.0000000, 0.1728137, 0.0050577,     0,  4217, 809377,  24402, 833779
179594,15037, 0.0404248, 0.0528192, 0.0419752,  8565,  1600, 211875,  30292, 242167
179594,15057, 0.0002681, 0.0239734, 0.0009619,   217,   585, 809377,  24402, 833779
179595,15037, 0.0212153, 0.0292486, 0.0222202,  4495,   886, 211875,  30292, 242167
179595,15057, 0.0000000, 0.0860995, 0.0025199,     0,  2101, 809377,  24402, 833779
179605,15058, 0.1513944, 0.5655518, 0.1536245,167228,  3382,1104585,   5980,1110565
179606,15058, 0.0882340, 0.4287626, 0.0900677, 97462,  2564,1104585,   5980,1110565
179607,15031, 0.2192615, 0.8777778, 0.2214799,134272,  1817, 612383,   2070, 614453
179610,15029, 0.4971461, 0.8683224, 0.5016709, 85966,  1853, 172919,   2134, 175053
179622,21180, 0.0000000, 0.1443135, 0.0422531,     0,  1543,  25826,  10692,  36518
179623,21180, 0.0000000, 0.0004676, 0.0001369,     0,     5,  25826,  10692,  36518
179624,29012, 0.0000000, 0.0003359, 0.0002381,     0,     2,   2445,   5954,   8399
179625,29012, 0.0000000, 0.0757474, 0.0536969,     0,   451,   2445,   5954,   8399
179626,29012, 0.0000000, 0.0035270, 0.0025003,     0,    21,   2445,   5954,   8399
179627,29015, 0.0000000, 0.0203390, 0.0059724,     0,   210,  24837,  10325,  35162
179628,29015, 0.0000000, 0.0676998, 0.0198794,     0,   699,  24837,  10325,  35162
179629,29014, 0.0000000, 0.0504119, 0.0220477,     0,   306,   7809,   6070,  13879
179630,29014, 0.0000000, 0.0003295, 0.0001441,     0,     2,   7809,   6070,  13879
179631,29024, 0.0659805, 0.0018170, 0.0392789,   968,    19,  14671,  10457,  25128
179633,29043, 0.0000000, 0.0016136, 0.0002418,     0,     8,  28123,   4958,  33081
179634,29043, 0.0433809, 0.4017749, 0.0970950,  1220,  1992,  28123,   4958,  33081
179635,29043, 0.3053728, 0.4485680, 0.3268341,  8588,  2224,  28123,   4958,  33081
179637,29038, 0.5604606, 0.0331050, 0.4656081,  6716,    87,  11983,   2628,  14611
179638,29038, 0.0015856, 0.0468037, 0.0097187,    19,   123,  11983,   2628,  14611
179638,29005, 0.0033011, 0.0085337, 0.0034775,   244,    22,  73914,   2578,  76492
179642,29013, 0.0000000, 0.1226051, 0.0224408,     0,  1907,  69425,  15554,  84979
179643,29013, 0.0000000, 0.0093867, 0.0017181,     0,   146,  69425,  15554,  84979
179644,29013, 0.0079366, 0.0817796, 0.0214524,   551,  1272,  69425,  15554,  84979
179646,29008, 0.0000000, 0.0081548, 0.0031453,     0,    43,   8398,   5273,  13671
179646,29004, 0.0000000, 0.1043852, 0.0793222,     0,  1264,   3826,  12109,  15935
179647,29008, 0.0000000, 0.0252228, 0.0097286,     0,   133,   8398,   5273,  13671
179647,29004, 0.0000000, 0.2134776, 0.1622215,     0,  2585,   3826,  12109,  15935
179648,29004, 0.0000000, 0.0580560, 0.0441167,     0,   703,   3826,  12109,  15935
179649,29004, 0.0000000, 0.2185977, 0.1661123,     0,  2647,   3826,  12109,  15935
179650,29004, 0.0000000, 0.0834090, 0.0633825,     0,  1010,   3826,  12109,  15935
179654,21108, 0.9917646, 0.0240254, 0.6053696,  9875,   159,   9957,   6618,  16575
180624,15111, 0.0000000, 0.0147444, 0.0128487,     0,   613,   6134,  41575,  47709
180625,15111, 0.0000000, 0.0227060, 0.0197866,     0,   944,   6134,  41575,  47709
180625,15114, 0.0000000, 0.0016677, 0.0016001,     0,   151,   3827,  90542,  94369
180626,15114, 0.0000000, 0.0098960, 0.0094946,     0,   896,   3827,  90542,  94369
180627,15114, 0.0000000, 0.0031919, 0.0030624,     0,   289,   3827,  90542,  94369
180628,15114, 0.0000000, 0.0356741, 0.0342273,     0,  3230,   3827,  90542,  94369
180629,15114, 0.0000000, 0.0151421, 0.0145281,     0,  1371,   3827,  90542,  94369
180630,15114, 0.0000000, 0.0509929, 0.0489250,     0,  4617,   3827,  90542,  94369
180632,15114, 0.0000000, 0.0447638, 0.0429484,     0,  4053,   3827,  90542,  94369
180633,15114, 0.0000000, 0.0327804, 0.0314510,     0,  2968,   3827,  90542,  94369
180634,15005, 0.0000000, 0.0655680, 0.0393152,     0,  5805,  59119,  88534, 147653
180635,15005, 0.0000000, 0.0351390, 0.0210697,     0,  3111,  59119,  88534, 147653
180636,15005, 0.0000000, 0.0176091, 0.0105585,     0,  1559,  59119,  88534, 147653
180637,15005, 0.0000000, 0.0160616, 0.0096307,     0,  1422,  59119,  88534, 147653
180638,15005, 0.0233935, 0.0059073, 0.0129086,  1383,   523,  59119,  88534, 147653
180639,15005, 0.0313266, 0.0097590, 0.0183945,  1852,   864,  59119,  88534, 147653
180640,15087, 0.0000000, 0.0568863, 0.0337185,     0,  3035,  36658,  53352,  90010
180642,15087, 0.0000000, 0.0071787, 0.0042551,     0,   383,  36658,  53352,  90010
180643,15087, 0.0348082, 0.0234480, 0.0280747,  1276,  1251,  36658,  53352,  90010
180644,15087, 0.2120683, 0.0499513, 0.1159760,  7774,  2665,  36658,  53352,  90010
180645,15087, 0.0090567, 0.0044047, 0.0062993,   332,   235,  36658,  53352,  90010
180646,15067, 0.0202229, 0.2028613, 0.1112149,   793,  7898,  39213,  38933,  78146
180647,15067, 0.0105322, 0.0447178, 0.0275638,   413,  1741,  39213,  38933,  78146
180648,15115, 0.0000000, 0.3300433, 0.1068183,     0,  4949,  31336,  14995,  46331
180648,15067, 0.1584169, 0.0213700, 0.0901390,  6212,   832,  39213,  38933,  78146
180649,15115, 0.0000000, 0.0627543, 0.0203104,     0,   941,  31336,  14995,  46331
180652,15057, 0.0000000, 0.0022539, 0.0000660,     0,    55, 809377,  24402, 833779
180653,15057, 0.0107935, 0.1908860, 0.0160642,  8736,  4658, 809377,  24402, 833779
180654,15057, 0.0023660, 0.0541349, 0.0038811,  1915,  1321, 809377,  24402, 833779
180655,15057, 0.1923331, 0.0023769, 0.1867737,155670,    58, 809377,  24402, 833779
180663,15058, 0.0325172, 0.0056856, 0.0323727, 35918,    34,1104585,   5980,1110565
180666,15031, 0.1644053, 0.0014493, 0.1638563,100679,     3, 612383,   2070, 614453
180668,15099, 0.0492435, 0.2330235, 0.0635379, 10679,  4262, 216861,  18290, 235151
180669,15099, 0.0440144, 0.0661017, 0.0457323,  9545,  1209, 216861,  18290, 235151
180670,15099, 0.0126164, 0.0087479, 0.0123155,  2736,   160, 216861,  18290, 235151
180681,21180, 0.0000000, 0.0970819, 0.0284243,     0,  1038,  25826,  10692,  36518
180682,29020, 0.0000000, 0.0075188, 0.0005900,     0,     5,   7809,    665,   8474
180683,29012, 0.0000000, 0.1268055, 0.0898917,     0,   755,   2445,   5954,   8399
180684,29012, 0.0000000, 0.2258985, 0.1601381,     0,  1345,   2445,   5954,   8399
180685,29012, 0.0179959, 0.1301646, 0.0975116,    44,   775,   2445,   5954,   8399
180686,29012, 0.0000000, 0.0594558, 0.0421479,     0,   354,   2445,   5954,   8399
180688,29014, 0.0000000, 0.0052718, 0.0023056,     0,    32,   7809,   6070,  13879
180689,29014, 0.0000000, 0.1192751, 0.0521651,     0,   724,   7809,   6070,  13879
180693,29040, 0.0278251, 0.4610711, 0.3050016,    98,  2884,   3522,   6255,   9777
180694,29040, 0.0000000, 0.0009592, 0.0006137,     0,     6,   3522,   6255,   9777
180694,29043, 0.4467873, 0.0060508, 0.3807321, 12565,    30,  28123,   4958,  33081
180695,29005, 0.2988608, 0.0298681, 0.2897950, 22090,    77,  73914,   2578,  76492
180697,29005, 0.0638039, 0.0023274, 0.0617319,  4716,     6,  73914,   2578,  76492
180698,29039, 0.3086148, 0.4763802, 0.3221554,  6176,   837,  20012,   1757,  21769
180699,29039, 0.0723066, 0.5173591, 0.1082273,  1447,   909,  20012,   1757,  21769
180700,29039, 0.0000000, 0.0062607, 0.0005053,     0,    11,  20012,   1757,  21769
180701,29013, 0.0000000, 0.0965668, 0.0176750,     0,  1502,  69425,  15554,  84979
180701,29030, 0.0000000, 0.2951542, 0.1215971,     0,  1675,   8100,   5675,  13775
180704,29013, 0.0000000, 0.0203163, 0.0037186,     0,   316,  69425,  15554,  84979
180705,29004, 0.0000000, 0.0213065, 0.0161908,     0,   258,   3826,  12109,  15935
180706,29004, 0.0036592, 0.0233710, 0.0186382,    14,   283,   3826,  12109,  15935
180707,29004, 0.3724516, 0.0008258, 0.0900533,  1425,    10,   3826,  12109,  15935
180710,21094, 0.0000000, 0.0203176, 0.0103070,     0,   325,  15536,  15996,  31532
180711,21094, 0.0000000, 0.0006877, 0.0003489,     0,    11,  15536,  15996,  31532
180713,21108, 0.0000000, 0.2422182, 0.0967119,     0,  1603,   9957,   6618,  16575
181683,15111, 0.0000000, 0.0025256, 0.0022008,     0,   105,   6134,  41575,  47709
181683,15124, 0.0000000, 0.0008150, 0.0007554,     0,    69,   6681,  84664,  91345
181684,15114, 0.0000000, 0.0004087, 0.0003921,     0,    37,   3827,  90542,  94369
181684,15124, 0.0000000, 0.0049135, 0.0045542,     0,   416,   6681,  84664,  91345
181685,15114, 0.0000000, 0.0093327, 0.0089542,     0,   845,   3827,  90542,  94369
181686,15114, 0.0000000, 0.0148219, 0.0142208,     0,  1342,   3827,  90542,  94369
181686,15124, 0.0000000, 0.0085515, 0.0079260,     0,   724,   6681,  84664,  91345
181687,15114, 0.0000000, 0.0147556, 0.0141572,     0,  1336,   3827,  90542,  94369
181688,15114, 0.0000000, 0.0109342, 0.0104907,     0,   990,   3827,  90542,  94369
181689,15114, 0.0000000, 0.0073115, 0.0070150,     0,   662,   3827,  90542,  94369
181690,15114, 0.0000000, 0.0385898, 0.0370249,     0,  3494,   3827,  90542,  94369
181691,15005, 0.0000000, 0.0052974, 0.0031764,     0,   469,  59119,  88534, 147653
181691,15114, 0.0000000, 0.0200459, 0.0192330,     0,  1815,   3827,  90542,  94369
181692,15005, 0.0000000, 0.0090022, 0.0053978,     0,   797,  59119,  88534, 147653
181693,15005, 0.0000000, 0.0077484, 0.0046460,     0,   686,  59119,  88534, 147653
181694,15005, 0.0000000, 0.0207604, 0.0124481,     0,  1838,  59119,  88534, 147653
181695,15005, 0.0000000, 0.0079066, 0.0047408,     0,   700,  59119,  88534, 147653
181696,15005, 0.0000000, 0.0351390, 0.0210697,     0,  3111,  59119,  88534, 147653
181697,15005, 0.0059203, 0.0000226, 0.0023840,   350,     2,  59119,  88534, 147653
181697,15042, 0.0000000, 0.0320344, 0.0129981,     0,  1839,  84075,  57407, 141482
181699,15087, 0.0000000, 0.0319576, 0.0189423,     0,  1705,  36658,  53352,  90010
181699,15042, 0.0000000, 0.0482171, 0.0195643,     0,  2768,  84075,  57407, 141482
181700,15087, 0.0000000, 0.0478707, 0.0283746,     0,  2554,  36658,  53352,  90010
181701,15106, 0.0025555, 0.0036280, 0.0026356,  1938,   222, 758370,  61191, 819561
181701,15087, 0.0000000, 0.0045547, 0.0026997,     0,   243,  36658,  53352,  90010
181702,15087, 0.0081838, 0.0366434, 0.0250528,   300,  1955,  36658,  53352,  90010
181703,15087, 0.0705167, 0.1311291, 0.1064437,  2585,  6996,  36658,  53352,  90010
181704,15087, 0.2893775, 0.1200330, 0.1890012, 10608,  6404,  36658,  53352,  90010
181705,15067, 0.0261138, 0.0839134, 0.0549100,  1024,  3267,  39213,  38933,  78146
181706,15067, 0.0247112, 0.0741017, 0.0493179,   969,  2885,  39213,  38933,  78146
181711,15046, 0.0000000, 0.0815883, 0.0459655,     0,   826,   7846,  10124,  17970
181712,15057, 0.0047740, 0.1298254, 0.0084339,  3864,  3168, 809377,  24402, 833779
181713,15057, 0.0000000, 0.0369232, 0.0010806,     0,   901, 809377,  24402, 833779
181714,15057, 0.0494516, 0.0917548, 0.0506897, 40025,  2239, 809377,  24402, 833779
181726,15099, 0.0000000, 0.0202843, 0.0015777,     0,   371, 216861,  18290, 235151
181727,15099, 0.0453470, 0.0025150, 0.0420156,  9834,    46, 216861,  18290, 235151
181728,15099, 0.0804478, 0.0913614, 0.0812967, 17446,  1671, 216861,  18290, 235151
181729,15099, 0.0102693, 0.0442318, 0.0129109,  2227,   809, 216861,  18290, 235151
181731,15099, 0.0001568, 0.1425916, 0.0112353,    34,  2608, 216861,  18290, 235151
181739,29021, 0.0000000, 0.3481963, 0.0933894,     0,  1554,  12177,   4463,  16640
181740,29020, 0.0000000, 0.0045113, 0.0003540,     0,     3,   7809,    665,   8474
181741,29020, 0.0000000, 0.1338346, 0.0105027,     0,    89,   7809,    665,   8474
181742,29012, 0.0000000, 0.0530736, 0.0376235,     0,   316,   2445,   5954,   8399
181743,29012, 0.0000000, 0.1551898, 0.1100131,     0,   924,   2445,   5954,   8399
181744,29012, 0.9378323, 0.0132684, 0.2824146,  2293,    79,   2445,   5954,   8399
181745,29012, 0.0000000, 0.0006718, 0.0004762,     0,     4,   2445,   5954,   8399
181746,29012, 0.0000000, 0.0010077, 0.0007144,     0,     6,   2445,   5954,   8399
181746,29014, 0.0144705, 0.0042834, 0.0100151,   113,    26,   7809,   6070,  13879
181747,29014, 0.3355103, 0.0115321, 0.1938180,  2620,    70,   7809,   6070,  13879
181748,29014, 0.0000000, 0.0245470, 0.0107356,     0,   149,   7809,   6070,  13879
181750,29040, 0.0000000, 0.0060751, 0.0038867,     0,    38,   3522,   6255,   9777
181750,29055, 0.0000000, 0.1518325, 0.0102365,     0,    29,   2642,    191,   2833
181751,29040, 0.0000000, 0.2789768, 0.1784801,     0,  1745,   3522,   6255,   9777
181752,29040, 0.0000000, 0.0047962, 0.0030684,     0,    30,   3522,   6255,   9777
181753,29043, 0.0164990, 0.0008068, 0.0141471,   464,     4,  28123,   4958,  33081
181753,29005, 0.0000000, 0.4480217, 0.0150996,     0,  1155,  73914,   2578,  76492
181754,29005, 0.0000000, 0.0480993, 0.0016211,     0,   124,  73914,   2578,  76492
181754,29031, 0.1400374, 0.0022032, 0.1226356,  3519,     8,  25129,   3631,  28760
181756,29005, 0.0000000, 0.4608223, 0.0155310,     0,  1188,  73914,   2578,  76492
181756,29031, 0.0596124, 0.0005508, 0.0521558,  1498,     2,  25129,   3631,  28760
181757,29031, 0.0000000, 0.0795924, 0.0100487,     0,   289,  25129,   3631,  28760
181758,29031, 0.0000000, 0.0013770, 0.0001739,     0,     5,  25129,   3631,  28760
181759,29031, 0.0000000, 0.0022032, 0.0002782,     0,     8,  25129,   3631,  28760
181761,29030, 0.0064198, 0.1686344, 0.0732486,    52,   957,   8100,   5675,  13775
181762,29013, 0.0000000, 0.0136299, 0.0024947,     0,   212,  69425,  15554,  84979
181762,29030, 0.0000000, 0.1053744, 0.0434120,     0,   598,   8100,   5675,  13775
181763,29004, 0.0000000, 0.0253530, 0.0192658,     0,   307,   3826,  12109,  15935
181764,29004, 0.0000000, 0.0369973, 0.0281142,     0,   448,   3826,  12109,  15935
181765,29004, 0.0000000, 0.0544223, 0.0413555,     0,   659,   3826,  12109,  15935
181766,29004, 0.6236278, 0.0130481, 0.1596486,  2386,   158,   3826,  12109,  15935
181767,29004, 0.0000000, 0.0466595, 0.0354565,     0,   565,   3826,  12109,  15935
181769,21094, 0.0009011, 0.0450113, 0.0232779,    14,   720,  15536,  15996,  31532
181770,21094, 0.0043126, 0.2409352, 0.1243499,    67,  3854,  15536,  15996,  31532
181771,21094, 0.0000000, 0.0004376, 0.0002220,     0,     7,  15536,  15996,  31532
181772,21094, 0.0000000, 0.0108152, 0.0054865,     0,   173,  15536,  15996,  31532
182742,15124, 0.0000000, 0.0176462, 0.0163556,     0,  1494,   6681,  84664,  91345
182743,15124, 0.0000000, 0.0318081, 0.0294816,     0,  2693,   6681,  84664,  91345
182744,15114, 0.0000000, 0.0068808, 0.0066017,     0,   623,   3827,  90542,  94369
182744,15124, 0.0000000, 0.0096145, 0.0089113,     0,   814,   6681,  84664,  91345
182745,15114, 0.0000000, 0.0126019, 0.0120908,     0,  1141,   3827,  90542,  94369
182746,15114, 0.0000000, 0.0191955, 0.0184171,     0,  1738,   3827,  90542,  94369
182746,15124, 0.0000000, 0.0012166, 0.0011276,     0,   103,   6681,  84664,  91345
182747,15114, 0.0000000, 0.0299530, 0.0287383,     0,  2712,   3827,  90542,  94369
182748,15114, 0.0000000, 0.0706081, 0.0677447,     0,  6393,   3827,  90542,  94369
182749,15114, 0.0000000, 0.0573325, 0.0550075,     0,  5191,   3827,  90542,  94369
182750,15005, 0.0000000, 0.0087537, 0.0052488,     0,   775,  59119,  88534, 147653
182750,15114, 0.0000000, 0.0202116, 0.0193920,     0,  1830,   3827,  90542,  94369
182751,15005, 0.0000000, 0.0197325, 0.0118318,     0,  1747,  59119,  88534, 147653
182752,15005, 0.0000000, 0.0073305, 0.0043954,     0,   649,  59119,  88534, 147653
182753,15005, 0.0000000, 0.0077033, 0.0046189,     0,   682,  59119,  88534, 147653
182755,15005, 0.0000000, 0.0012312, 0.0007382,     0,   109,  59119,  88534, 147653
182755,15042, 0.0000000, 0.0202066, 0.0081989,     0,  1160,  84075,  57407, 141482
182756,15042, 0.0000000, 0.0794154, 0.0322232,     0,  4559,  84075,  57407, 141482
182757,15042, 0.0000000, 0.0375912, 0.0152528,     0,  2158,  84075,  57407, 141482
182759,15047, 0.0000000, 0.0001444, 0.0001304,     0,     9,   6718,  62313,  69031
182761,15047, 0.0000000, 0.0138815, 0.0125306,     0,   865,   6718,  62313,  69031
182762,15087, 0.0000000, 0.0136077, 0.0080658,     0,   726,  36658,  53352,  90010
182763,15087, 0.1314311, 0.1970873, 0.1703477,  4818, 10515,  36658,  53352,  90010
182764,15087, 0.0134759, 0.0095404, 0.0111432,   494,   509,  36658,  53352,  90010
182766,15067, 0.0000000, 0.0002055, 0.0001024,     0,     8,  39213,  38933,  78146
182769,15046, 0.1850625, 0.0738838, 0.1224263,  1452,   748,   7846,  10124,  17970
182770,15046, 0.4226357, 0.3868036, 0.4024485,  3316,  3916,   7846,  10124,  17970
182771,15057, 0.0000000, 0.0249980, 0.0007316,     0,   610, 809377,  24402, 833779
182771,15046, 0.0975019, 0.0867246, 0.0914302,   765,   878,   7846,  10124,  17970
182772,15057, 0.0000000, 0.0411032, 0.0012030,     0,  1003, 809377,  24402, 833779
182773,15057, 0.0542701, 0.0850340, 0.0551705, 43925,  2075, 809377,  24402, 833779
182785,15099, 0.0000000, 0.0015856, 0.0001233,     0,    29, 216861,  18290, 235151
182786,15099, 0.0328136, 0.1303445, 0.0403996,  7116,  2384, 216861,  18290, 235151
182788,15099, 0.0482844, 0.0307818, 0.0469230, 10471,   563, 216861,  18290, 235151
182789,15099, 0.0400118, 0.0006014, 0.0369465,  8677,    11, 216861,  18290, 235151
182790,15099, 0.0096652, 0.0002187, 0.0089304,  2096,     4, 216861,  18290, 235151
182797,29021, 0.0000000, 0.0002241, 0.0000601,     0,     1,  12177,   4463,  16640
182798,29021, 0.0000000, 0.0040332, 0.0010817,     0,    18,  12177,   4463,  16640
182799,29021, 0.9790589, 0.1653596, 0.7608173, 11922,   738,  12177,   4463,  16640
182800,29021, 0.0000000, 0.0024647, 0.0006611,     0,    11,  12177,   4463,  16640
182800,29012, 0.0000000, 0.0006718, 0.0004762,     0,     4,   2445,   5954,   8399
182800,29020, 0.0000000, 0.0225564, 0.0017701,     0,    15,   7809,    665,   8474
182801,29012, 0.0000000, 0.0134363, 0.0095249,     0,    80,   2445,   5954,   8399
182803,29012, 0.0441718, 0.0811219, 0.0703655,   108,   483,   2445,   5954,   8399
182804,29012, 0.0000000, 0.0596238, 0.0422669,     0,   355,   2445,   5954,   8399
182805,29014, 0.0898963, 0.1074135, 0.0975575,   702,   652,   7809,   6070,  13879
182806,29014, 0.1890127, 0.0182867, 0.1143454,  1476,   111,   7809,   6070,  13879
182807,29014, 0.1211423, 0.1779242, 0.1459759,   946,  1080,   7809,   6070,  13879
182808,29014, 0.2497119, 0.0004942, 0.1407162,  1950,     3,   7809,   6070,  13879
182808,29055, 0.1324754, 0.0261780, 0.1253089,   350,     5,   2642,    191,   2833
182808,29040, 0.0000000, 0.0012790, 0.0008182,     0,     8,   3522,   6255,   9777
182809,29040, 0.0000000, 0.0326139, 0.0208653,     0,   204,   3522,   6255,   9777
182809,29055, 0.8444360, 0.3141361, 0.8086834,  2231,    60,   2642,    191,   2833
182810,29055, 0.0000000, 0.0366492, 0.0024709,     0,     7,   2642,    191,   2833
182810,29040, 0.0000000, 0.0596323, 0.0381508,     0,   373,   3522,   6255,   9777
182811,29040, 0.0000000, 0.0031974, 0.0020456,     0,    20,   3522,   6255,   9777
182811,29011, 0.5294985, 0.1434918, 0.3267211,  1077,   323,   2034,   2251,   4285
182811,29003, 0.0000000, 0.0016251, 0.0014955,     0,     9,    480,   5538,   6018
182812,29005, 0.0000000, 0.0023274, 0.0000784,     0,     6,  73914,   2578,  76492
182812,29031, 0.0264634, 0.0041311, 0.0236440,   665,    15,  25129,   3631,  28760
182813,29031, 0.1064109, 0.0074360, 0.0939152,  2674,    27,  25129,   3631,  28760
182814,29031, 0.0614032, 0.0137703, 0.0553894,  1543,    50,  25129,   3631,  28760
182815,29031, 0.0000000, 0.0013770, 0.0001739,     0,     5,  25129,   3631,  28760
182816,29031, 0.0000000, 0.0082622, 0.0010431,     0,    30,  25129,   3631,  28760
182821,29030, 0.3659259, 0.0800000, 0.2481307,  2964,   454,   8100,   5675,  13775
182822,29030, 0.0000000, 0.0091630, 0.0037750,     0,    52,   8100,   5675,  13775
182823,29030, 0.0000000, 0.0035242, 0.0014519,     0,    20,   8100,   5675,  13775
182823,21083, 0.0000000, 0.0239619, 0.0236516,     0,   599,    328,  24998,  25326
182828,21094, 0.1192070, 0.0742686, 0.0964100,  1852,  1188,  15536,  15996,  31532
182829,21094, 0.8755149, 0.0123781, 0.4376507, 13602,   198,  15536,  15996,  31532
182830,21094, 0.0000000, 0.0048137, 0.0024420,     0,    77,  15536,  15996,  31532
182831,21094, 0.0000000, 0.1102776, 0.0559432,     0,  1764,  15536,  15996,  31532
183802,15124, 0.0000000, 0.0538482, 0.0499097,     0,  4559,   6681,  84664,  91345
183803,15124, 0.0000000, 0.0585609, 0.0542777,     0,  4958,   6681,  84664,  91345
183805,15124, 0.0000000, 0.0129099, 0.0119656,     0,  1093,   6681,  84664,  91345
183806,15114, 0.0000000, 0.0167657, 0.0160858,     0,  1518,   3827,  90542,  94369
183806,15124, 0.0000000, 0.0051143, 0.0047403,     0,   433,   6681,  84664,  91345
183807,15114, 0.0000000, 0.0261205, 0.0250612,     0,  2365,   3827,  90542,  94369
183808,15114, 0.0000000, 0.0307702, 0.0295224,     0,  2786,   3827,  90542,  94369
183809,15114, 0.0000000, 0.0438912, 0.0421113,     0,  3974,   3827,  90542,  94369
183809,15074, 0.0002953, 0.0123679, 0.0076526,    14,   915,  47414,  73982, 121396
183810,15005, 0.0000000, 0.0227822, 0.0136604,     0,  2017,  59119,  88534, 147653
183810,15074, 0.0000000, 0.0009732, 0.0005931,     0,    72,  47414,  73982, 121396
183812,15042, 0.0027000, 0.0018290, 0.0023466,   227,   105,  84075,  57407, 141482
183813,15005, 0.0000000, 0.0001130, 0.0000677,     0,    10,  59119,  88534, 147653
183813,15042, 0.0080880, 0.0199801, 0.0129133,   680,  1147,  84075,  57407, 141482
183815,15042, 0.0324829, 0.0048775, 0.0212819,  2731,   280,  84075,  57407, 141482
183817,15047, 0.0000000, 0.0236387, 0.0213382,     0,  1473,   6718,  62313,  69031
183817,15042, 0.0000000, 0.0002787, 0.0001131,     0,    16,  84075,  57407, 141482
183818,15047, 0.0000000, 0.0160641, 0.0145007,     0,  1001,   6718,  62313,  69031
183819,15047, 0.0000000, 0.0325775, 0.0294071,     0,  2030,   6718,  62313,  69031
183820,15047, 0.0000000, 0.0318072, 0.0287117,     0,  1982,   6718,  62313,  69031
183821,15047, 0.0047633, 0.1104585, 0.1001724,    32,  6883,   6718,  62313,  69031
183822,15047, 0.0000000, 0.0143790, 0.0129797,     0,   896,   6718,  62313,  69031
183823,15087, 0.0000000, 0.0104214, 0.0061771,     0,   556,  36658,  53352,  90010
183825,15038, 0.0000000, 0.0167349, 0.0134847,     0,   139,   2002,   8306,  10308
183826,15038, 0.0000000, 0.0028895, 0.0023283,     0,    24,   2002,   8306,  10308
183827,15046, 0.0000000, 0.0014816, 0.0008347,     0,    15,   7846,  10124,  17970
183828,15046, 0.1823859, 0.3565784, 0.2805231,  1431,  3610,   7846,  10124,  17970
183830,15046, 0.0000000, 0.0129395, 0.0072899,     0,   131,   7846,  10124,  17970
183832,15057, 0.0047432, 0.0099172, 0.0048946,  3839,   242, 809377,  24402, 833779
183833,15013, 0.0698953, 0.1287001, 0.0699886, 34190,   100, 489160,    777, 489937
183844,15099, 0.0000000, 0.0063969, 0.0004976,     0,   117, 216861,  18290, 235151
183844,15011, 0.0000000, 0.0368910, 0.0113081,     0,   636,  39003,  17240,  56243
183845,15099, 0.0854833, 0.0996173, 0.0865827, 18538,  1822, 216861,  18290, 235151
183845,15011, 0.0000000, 0.1475638, 0.0452323,     0,  2544,  39003,  17240,  56243
183847,15099, 0.0451856, 0.0019683, 0.0418242,  9799,    36, 216861,  18290, 235151
183848,15099, 0.0338097, 0.0191361, 0.0326684,  7332,   350, 216861,  18290, 235151
183849,15099, 0.0050954, 0.0148715, 0.0058558,  1105,   272, 216861,  18290, 235151
183850,15099, 0.0282762, 0.0094587, 0.0268126,  6132,   173, 216861,  18290, 235151
183851,15099, 0.0035968, 0.0194095, 0.0048267,   780,   355, 216861,  18290, 235151
183851,15093, 0.0055270, 0.1220852, 0.0579373,    85,  1534,  15379,  12565,  27944
183856,29021, 0.0000000, 0.0481739, 0.0129207,     0,   215,  12177,   4463,  16640
183856,29006, 0.0000000, 0.0122060, 0.0024327,     0,   109,  35877,   8930,  44807
183857,29021, 0.0000000, 0.0006722, 0.0001803,     0,     3,  12177,   4463,  16640
183857,29006, 0.0000000, 0.0077268, 0.0015399,     0,    69,  35877,   8930,  44807
183858,29021, 0.0209411, 0.0073941, 0.0173077,   255,    33,  12177,   4463,  16640
183859,29021, 0.0000000, 0.0096348, 0.0025841,     0,    43,  12177,   4463,  16640
183860,29020, 0.0052504, 0.0060150, 0.0053104,    41,     4,   7809,    665,   8474
183860,29021, 0.0000000, 0.4071253, 0.1091947,     0,  1817,  12177,   4463,  16640
183861,29020, 0.0000000, 0.0060150, 0.0004720,     0,     4,   7809,    665,   8474
183862,29014, 0.0000000, 0.0001647, 0.0000721,     0,     1,   7809,   6070,  13879
183863,29014, 0.0000000, 0.1448105, 0.0633331,     0,   879,   7809,   6070,  13879
183864,29014, 0.0000000, 0.0009885, 0.0004323,     0,     6,   7809,   6070,  13879
183867,29011, 0.0000000, 0.0039982, 0.0021004,     0,     9,   2034,   2251,   4285
183868,29055, 0.0227101, 0.4712042, 0.0529474,    60,    90,   2642,    191,   2833
183868,29011, 0.0000000, 0.8063083, 0.4235706,     0,  1815,   2034,   2251,   4285
183869,29011, 0.0000000, 0.0457574, 0.0240373,     0,   103,   2034,   2251,   4285
183869,29003, 0.0000000, 0.0018057, 0.0016617,     0,    10,    480,   5538,   6018
183870,29003, 0.0000000, 0.0025280, 0.0023264,     0,    14,    480,   5538,   6018
183871,29003, 0.0000000, 0.0046948, 0.0043204,     0,    26,    480,   5538,   6018
183872,29031, 0.0000000, 0.0156982, 0.0019819,     0,    57,  25129,   3631,  28760
183872,29003, 0.0000000, 0.0028891, 0.0026587,     0,    16,    480,   5538,   6018
183873,29031, 0.0000000, 0.1495456, 0.0188804,     0,   543,  25129,   3631,  28760
183873,29003, 0.0000000, 0.0651860, 0.0599867,     0,   361,    480,   5538,   6018
183874,29034, 0.0000000, 0.0024643, 0.0013521,     0,    54,  18026,  21913,  39939
183874,29031, 0.0000000, 0.0022032, 0.0002782,     0,     8,  25129,   3631,  28760
183875,29031, 0.0000000, 0.2021482, 0.0255216,     0,   734,  25129,   3631,  28760
183876,29031, 0.0000000, 0.0002754, 0.0000348,     0,     1,  25129,   3631,  28760
183876,29047, 0.0000000, 0.0026316, 0.0003611,     0,     1,   2389,    380,   2769
183877,29030, 0.0000000, 0.0007048, 0.0002904,     0,     4,   8100,   5675,  13775
183880,29030, 0.0040741, 0.0230837, 0.0119056,    33,   131,   8100,   5675,  13775
183881,29030, 0.0000000, 0.0311894, 0.0128494,     0,   177,   8100,   5675,  13775
183881,21083, 0.0000000, 0.0298024, 0.0294164,     0,   745,    328,  24998,  25326
183882,21083, 0.0000000, 0.0035603, 0.0035142,     0,    89,    328,  24998,  25326
183883,29004, 0.0000000, 0.0240317, 0.0182617,     0,   291,   3826,  12109,  15935
183883,21083, 0.0000000, 0.0516841, 0.0510148,     0,  1292,    328,  24998,  25326
183885,21094, 0.0000000, 0.0048762, 0.0024737,     0,    78,  15536,  15996,  31532
183886,21094, 0.0000000, 0.0670793, 0.0340289,     0,  1073,  15536,  15996,  31532
183887,21094, 0.0000000, 0.0041260, 0.0020931,     0,    66,  15536,  15996,  31532
183888,21094, 0.0000000, 0.1347212, 0.0683433,     0,  2155,  15536,  15996,  31532
183889,21094, 0.0000000, 0.1307202, 0.0663136,     0,  2091,  15536,  15996,  31532
183890,21094, 0.0000000, 0.0001250, 0.0000634,     0,     2,  15536,  15996,  31532
184860,15124, 0.0000000, 0.0419777, 0.0389074,     0,  3554,   6681,  84664,  91345
184861,15124, 0.0000000, 0.0399580, 0.0370354,     0,  3383,   6681,  84664,  91345
184862,15124, 0.0000000, 0.0307569, 0.0285073,     0,  2604,   6681,  84664,  91345
184864,15124, 0.0000000, 0.0129099, 0.0119656,     0,  1093,   6681,  84664,  91345
184865,15124, 0.0000000, 0.0206109, 0.0191034,     0,  1745,   6681,  84664,  91345
184866,15074, 0.0044080, 0.0160850, 0.0115243,   209,  1190,  47414,  73982, 121396
184867,15074, 0.0210486, 0.0163959, 0.0182131,   998,  1213,  47414,  73982, 121396
184868,15074, 0.0002742, 0.0328999, 0.0201572,    13,  2434,  47414,  73982, 121396
184869,15074, 0.0000000, 0.0103944, 0.0063346,     0,   769,  47414,  73982, 121396
184869,15042, 0.0003211, 0.0020207, 0.0010107,    27,   116,  84075,  57407, 141482
184870,15042, 0.0124056, 0.0197014, 0.0153659,  1043,  1131,  84075,  57407, 141482
184871,15042, 0.0024621, 0.1251415, 0.0522399,   207,  7184,  84075,  57407, 141482
184873,15042, 0.0320428, 0.0761405, 0.0499357,  2694,  4371,  84075,  57407, 141482
184874,15042, 0.0856021, 0.0514223, 0.0717335,  7197,  2952,  84075,  57407, 141482
184875,15042, 0.0497056, 0.0801993, 0.0620786,  4179,  4604,  84075,  57407, 141482
184876,15042, 0.0000000, 0.0156775, 0.0063612,     0,   900,  84075,  57407, 141482
184876,15047, 0.0000000, 0.1662574, 0.1500775,     0, 10360,   6718,  62313,  69031
184877,15047, 0.2216433, 0.0421581, 0.0596254,  1489,  2627,   6718,  62313,  69031
184878,15047, 0.0000000, 0.0406817, 0.0367226,     0,  2535,   6718,  62313,  69031
184879,15047, 0.0232212, 0.0382745, 0.0368095,   156,  2385,   6718,  62313,  69031
184880,15047, 0.2604942, 0.0533757, 0.0735322,  1750,  3326,   6718,  62313,  69031
184881,15047, 0.0000000, 0.0002728, 0.0002463,     0,    17,   6718,  62313,  69031
184885,15038, 0.0000000, 0.0233566, 0.0188203,     0,   194,   2002,   8306,  10308
184886,15038, 0.9580420, 0.3278353, 0.4502328,  1918,  2723,   2002,   8306,  10308
184887,15038, 0.0419580, 0.4071755, 0.3362437,    84,  3382,   2002,   8306,  10308
184889,15013, 0.0018522, 0.1402831, 0.0020717,   906,   109, 489160,    777, 489937
184889,15038, 0.0000000, 0.0784975, 0.0632518,     0,   652,   2002,   8306,  10308
184890,15013, 0.0179042, 0.7052767, 0.0189943,  8758,   548, 489160,    777, 489937
184895,15104, 0.1110721, 0.4387755, 0.1111205, 73766,    43, 664127,     98, 664225
184897,15104, 0.0521271, 0.5102041, 0.0521947, 34619,    50, 664127,     98, 664225
184903,15011, 0.0146655, 0.0773782, 0.0338887,   572,  1334,  39003,  17240,  56243
184904,15011, 0.3852268, 0.4631090, 0.4090998, 15025,  7984,  39003,  17240,  56243
184905,15028, 0.5735947, 0.1578212, 0.4258333,  9684,  1469,  16883,   9308,  26191
184905,15030, 0.2325881, 1.0000000, 0.2689425,  5056,  1081,  21738,   1081,  22819
184905,15069, 0.0061335, 1.0000000, 0.0231493,    25,    71,   4076,     71,   4147
184906,15099, 0.0253434, 0.0472936, 0.0270507,  5496,   865, 216861,  18290, 235151
184906,15093, 0.0000000, 0.1513729, 0.0680647,     0,  1902,  15379,  12565,  27944
184907,15099, 0.0243289, 0.0094587, 0.0231723,  5276,   173, 216861,  18290, 235151
184907,15093, 0.0001300, 0.0822921, 0.0370741,     2,  1034,  15379,  12565,  27944
184908,15093, 0.0000000, 0.2966972, 0.1334097,     0,  3728,  15379,  12565,  27944
184909,15093, 0.0211977, 0.0121767, 0.0171414,   326,   153,  15379,  12565,  27944
184910,15093, 0.2005332, 0.0007163, 0.1106857,  3084,     9,  15379,  12565,  27944
184914,29006, 0.0000000, 0.1350504, 0.0269154,     0,  1206,  35877,   8930,  44807
184915,29006, 0.0000000, 0.0031355, 0.0006249,     0,    28,  35877,   8930,  44807
184916,29006, 0.0000000, 0.2244121, 0.0447252,     0,  2004,  35877,   8930,  44807
184916,29021, 0.0000000, 0.0006722, 0.0001803,     0,     3,  12177,   4463,  16640
184917,29021, 0.0000000, 0.0024647, 0.0006611,     0,    11,  12177,   4463,  16640
184917,29006, 0.0000000, 0.0005599, 0.0001116,     0,     5,  35877,   8930,  44807
184918,29021, 0.0000000, 0.0029128, 0.0007813,     0,    13,  12177,   4463,  16640
184918,29006, 0.0000000, 0.0012318, 0.0002455,     0,    11,  35877,   8930,  44807
184919,29021, 0.0000000, 0.0006722, 0.0001803,     0,     3,  12177,   4463,  16640
184919,29006, 0.0000000, 0.0003359, 0.0000670,     0,     3,  35877,   8930,  44807
184922,29014, 0.0000000, 0.0001647, 0.0000721,     0,     1,   7809,   6070,  13879
184923,29014, 0.0000000, 0.0812191, 0.0355213,     0,   493,   7809,   6070,  13879
184925,29014, 0.0000000, 0.0028007, 0.0012249,     0,    17,   7809,   6070,  13879
184927,29011, 0.0000000, 0.0004442, 0.0002334,     0,     1,   2034,   2251,   4285
184928,29003, 0.8083333, 0.1343445, 0.1881024,   388,   744,    480,   5538,   6018
184929,29003, 0.1916667, 0.0045143, 0.0194417,    92,    25,    480,   5538,   6018
184930,29003, 0.0000000, 0.3261105, 0.3000997,     0,  1806,    480,   5538,   6018
184931,29003, 0.0000000, 0.0153485, 0.0141243,     0,    85,    480,   5538,   6018
184931,29034, 0.0000000, 0.0004564, 0.0002504,     0,    10,  18026,  21913,  39939
184932,29003, 0.0000000, 0.0007223, 0.0006647,     0,     4,    480,   5538,   6018
184932,29034, 0.0000000, 0.0021905, 0.0012018,     0,    48,  18026,  21913,  39939
184933,29034, 0.0000000, 0.0159266, 0.0087383,     0,   349,  18026,  21913,  39939
184934,29031, 0.0000000, 0.3825392, 0.0482962,     0,  1389,  25129,   3631,  28760
184935,29031, 0.0000000, 0.1266869, 0.0159944,     0,   460,  25129,   3631,  28760
184936,29047, 0.8999581, 0.9078947, 0.9010473,  2150,   345,   2389,    380,   2769
184938,29030, 0.0000000, 0.0012335, 0.0005082,     0,     7,   8100,   5675,  13775
184938,29046, 0.0000000, 0.0084421, 0.0026532,     0,    11,   2843,   1303,   4146
184939,29030, 0.0000000, 0.2757709, 0.1136116,     0,  1565,   8100,   5675,  13775
184940,21083, 0.0000000, 0.0071606, 0.0070678,     0,   179,    328,  24998,  25326
184940,29030, 0.0000000, 0.0061674, 0.0025408,     0,    35,   8100,   5675,  13775
184941,21083, 0.0000000, 0.0000400, 0.0000395,     0,     1,    328,  24998,  25326
184942,21083, 0.0000000, 0.0004000, 0.0003949,     0,    10,    328,  24998,  25326
184943,21083, 0.0000000, 0.0137611, 0.0135829,     0,   344,    328,  24998,  25326
184944,21094, 0.0000000, 0.0535759, 0.0271787,     0,   857,  15536,  15996,  31532
184946,21094, 0.0000000, 0.0123781, 0.0062793,     0,   198,  15536,  15996,  31532
184947,21094, 0.0000000, 0.0627032, 0.0318090,     0,  1003,  15536,  15996,  31532
184948,21105, 0.0000000, 0.0039359, 0.0029016,     0,    14,   1268,   3557,   4825
184948,21094, 0.0000000, 0.0070643, 0.0035837,     0,   113,  15536,  15996,  31532
184949,21094, 0.0000000, 0.0006252, 0.0003171,     0,    10,  15536,  15996,  31532
184949,21105, 0.0000000, 0.0075907, 0.0055959,     0,    27,   1268,   3557,   4825
185919,15124, 0.0000000, 0.0318553, 0.0295254,     0,  2697,   6681,  84664,  91345
185920,15124, 0.0000000, 0.0508835, 0.0471619,     0,  4308,   6681,  84664,  91345
185921,15124, 0.0000000, 0.0118350, 0.0109694,     0,  1002,   6681,  84664,  91345
185922,15124, 0.0049394, 0.0309340, 0.0290328,    33,  2619,   6681,  84664,  91345
185923,15124, 0.0000000, 0.0054805, 0.0050796,     0,   464,   6681,  84664,  91345
185923,15074, 0.0242755, 0.0124895, 0.0170928,  1151,   924,  47414,  73982, 121396
185924,15074, 0.0316784, 0.0548241, 0.0457840,  1502,  4056,  47414,  73982, 121396
185925,15074, 0.0738389, 0.0337785, 0.0494250,  3501,  2499,  47414,  73982, 121396
185926,15074, 0.0000000, 0.0601092, 0.0366322,     0,  4447,  47414,  73982, 121396
185927,15074, 0.0000000, 0.0322511, 0.0196547,     0,  2386,  47414,  73982, 121396
185928,15074, 0.0350108, 0.0038523, 0.0160219,  1660,   285,  47414,  73982, 121396
185929,15042, 0.0464109, 0.0446461, 0.0456949,  3902,  2563,  84075,  57407, 141482
185930,15042, 0.0045674, 0.0171756, 0.0096832,   384,   986,  84075,  57407, 141482
185931,15042, 0.0371692, 0.0073859, 0.0250845,  3125,   424,  84075,  57407, 141482
185932,15042, 0.0504193, 0.0401345, 0.0462462,  4239,  2304,  84075,  57407, 141482
185933,15042, 0.1034909, 0.0048426, 0.0634639,  8701,   278,  84075,  57407, 141482
185934,15042, 0.0863515, 0.0032923, 0.0526498,  7260,   189,  84075,  57407, 141482
185935,15047, 0.0000000, 0.0083610, 0.0075473,     0,   521,   6718,  62313,  69031
185936,15047, 0.0113129, 0.0326256, 0.0305515,    76,  2033,   6718,  62313,  69031
185937,15047, 0.1507889, 0.0568742, 0.0660138,  1013,  3544,   6718,  62313,  69031
185938,15047, 0.0000000, 0.0194181, 0.0175284,     0,  1210,   6718,  62313,  69031
185939,15047, 0.0000000, 0.0311813, 0.0281468,     0,  1943,   6718,  62313,  69031
185940,15047, 0.0000000, 0.0002568, 0.0002318,     0,    16,   6718,  62313,  69031
185945,15060, 0.0038962, 0.0268077, 0.0060993,  1291,   945, 331351,  35251, 366602
185946,15060, 0.0071495, 0.0008510, 0.0065439,  2369,    30, 331351,  35251, 366602
185947,15038, 0.0000000, 0.1265350, 0.1019596,     0,  1051,   2002,   8306,  10308
185947,15060, 0.0000000, 0.0251057, 0.0024141,     0,   885, 331351,  35251, 366602
185948,15038, 0.0000000, 0.0169757, 0.0136787,     0,   141,   2002,   8306,  10308
185948,15060, 0.0000000, 0.1240532, 0.0119285,     0,  4373, 331351,  35251, 366602
185950,15013, 0.0439406, 0.0257400, 0.0439118, 21494,    20, 489160,    777, 489937
185954,15109, 0.1399939, 0.7392492, 0.1433443, 72957,  2166, 521144,   2930, 524074
185955,15109, 0.0000000, 0.0003413, 0.0000019,     0,     1, 521144,   2930, 524074
185956,15104, 0.0000000, 0.0510204, 0.0000075,     0,     5, 664127,     98, 664225
185960,15011, 0.0000000, 0.2069025, 0.0634212,     0,  3567,  39003,  17240,  56243
185962,15011, 0.2813886, 0.0199536, 0.2012517, 10975,   344,  39003,  17240,  56243
185962,15100, 0.0387253, 0.2005731, 0.0483536,  1282,   420,  33105,   2094,  35199
185963,15011, 0.0394585, 0.0482019, 0.0421386,  1539,   831,  39003,  17240,  56243
185963,15100, 0.1274732, 0.6977077, 0.1613966,  4220,  1461,  33105,   2094,  35199
185964,15028, 0.1227270, 0.7248603, 0.3367187,  2072,  6747,  16883,   9308,  26191
185965,15093, 0.3670590, 0.0389176, 0.2195105,  5645,   489,  15379,  12565,  27944
185966,15093, 0.3823396, 0.0553920, 0.2353278,  5880,   696,  15379,  12565,  27944
185967,15093, 0.0156707, 0.2206128, 0.1078228,   241,  2772,  15379,  12565,  27944
185968,15093, 0.0000000, 0.0012734, 0.0005726,     0,    16,  15379,  12565,  27944
185971,29006, 0.0000000, 0.0128779, 0.0025666,     0,   115,  35877,   8930,  44807
185972,29006, 0.0000000, 0.0698768, 0.0139264,     0,   624,  35877,   8930,  44807
185974,29006, 0.0000557, 0.0088466, 0.0018078,     2,    79,  35877,   8930,  44807
185975,29006, 0.2971542, 0.0007839, 0.2380878, 10661,     7,  35877,   8930,  44807
185976,29006, 0.0008919, 0.0014558, 0.0010043,    32,    13,  35877,   8930,  44807
185977,29006, 0.0000000, 0.0029115, 0.0005803,     0,    26,  35877,   8930,  44807
185978,29006, 0.0000000, 0.0642777, 0.0128105,     0,   574,  35877,   8930,  44807
185979,29020, 0.0659495, 0.0090226, 0.0614822,   515,     6,   7809,    665,   8474
185980,29020, 0.0000000, 0.0090226, 0.0007080,     0,     6,   7809,    665,   8474
185980,29045, 0.1080367, 0.5384616, 0.1090206,   613,     7,   5674,     13,   5687
185982,29014, 0.0000000, 0.2490939, 0.1089416,     0,  1512,   7809,   6070,  13879
185982,29034, 0.0000000, 0.0010496, 0.0005759,     0,    23,  18026,  21913,  39939
185983,29014, 0.0000000, 0.0009885, 0.0004323,     0,     6,   7809,   6070,  13879
185984,29034, 0.0000000, 0.0266508, 0.0146223,     0,   584,  18026,  21913,  39939
185985,29034, 0.0000000, 0.0807740, 0.0443176,     0,  1770,  18026,  21913,  39939
185986,29034, 0.0000000, 0.0004564, 0.0002504,     0,    10,  18026,  21913,  39939
185986,29003, 0.0000000, 0.0068617, 0.0063144,     0,    38,    480,   5538,   6018
185987,29003, 0.0000000, 0.2354641, 0.2166833,     0,  1304,    480,   5538,   6018
185988,29003, 0.0000000, 0.0126399, 0.0116318,     0,    70,    480,   5538,   6018
185989,29003, 0.0000000, 0.0287107, 0.0264207,     0,   159,    480,   5538,   6018
185990,29003, 0.0000000, 0.0048754, 0.0044865,     0,    27,    480,   5538,   6018
185990,29034, 0.0000000, 0.0135080, 0.0074113,     0,   296,  18026,  21913,  39939
185991,29034, 0.0000000, 0.0104961, 0.0057588,     0,   230,  18026,  21913,  39939
185992,29034, 0.0000000, 0.0003194, 0.0001753,     0,     7,  18026,  21913,  39939
185994,29034, 0.0000000, 0.0229544, 0.0125942,     0,   503,  18026,  21913,  39939
185995,29047, 0.0334868, 0.0605263, 0.0371975,    80,    23,   2389,    380,   2769
185995,29034, 0.0000000, 0.0095834, 0.0052580,     0,   210,  18026,  21913,  39939
185996,29047, 0.0000000, 0.0289474, 0.0039726,     0,    11,   2389,    380,   2769
185997,29046, 0.1839606, 0.0460476, 0.1406175,   523,    60,   2843,   1303,   4146
185998,29046, 0.8160394, 0.0360706, 0.5709117,  2320,    47,   2843,   1303,   4146
185999,29046, 0.0000000, 0.0069071, 0.0021708,     0,     9,   2843,   1303,   4146
185999,21083, 0.0000000, 0.0003200, 0.0003159,     0,     8,    328,  24998,  25326
186000,21083, 0.0000000, 0.0101608, 0.0100292,     0,   254,    328,  24998,  25326
186001,21083, 0.0000000, 0.0033203, 0.0032773,     0,    83,    328,  24998,  25326
186002,21083, 0.0000000, 0.0302824, 0.0298902,     0,   757,    328,  24998,  25326
186003,21083, 0.0000000, 0.0741259, 0.0731659,     0,  1853,    328,  24998,  25326
186004,21083, 0.0000000, 0.0236419, 0.0233357,     0,   591,    328,  24998,  25326
186005,21105, 0.0000000, 0.1020523, 0.0752332,     0,   363,   1268,   3557,   4825
186006,21105, 0.0000000, 0.0714085, 0.0526425,     0,   254,   1268,   3557,   4825
186007,21105, 0.9771293, 0.7475401, 0.8078756,  1239,  2659,   1268,   3557,   4825
186008,21105, 0.0000000, 0.0089963, 0.0066321,     0,    32,   1268,   3557,   4825
186008,21044, 0.0200948, 0.0007927, 0.0074185,   106,     8,   5275,  10092,  15367
186978,15124, 0.0000000, 0.0463715, 0.0429799,     0,  3926,   6681,  84664,  91345
186979,15124, 0.0000000, 0.0141028, 0.0130713,     0,  1194,   6681,  84664,  91345
186980,15124, 0.0000000, 0.0123665, 0.0114620,     0,  1047,   6681,  84664,  91345
186981,15124, 0.2933693, 0.0041576, 0.0253106,  1960,   352,   6681,  84664,  91345
186982,15074, 0.0189817, 0.0149225, 0.0165080,   900,  1104,  47414,  73982, 121396
186984,15074, 0.0570296, 0.0025682, 0.0238393,  2704,   190,  47414,  73982, 121396
186985,15074, 0.0000000, 0.0375226, 0.0228673,     0,  2776,  47414,  73982, 121396
186987,15074, 0.1205973, 0.0106648, 0.0536014,  5718,   789,  47414,  73982, 121396
186988,15074, 0.0115578, 0.0338866, 0.0251656,   548,  2507,  47414,  73982, 121396
186990,15042, 0.0139280, 0.0116188, 0.0129911,  1171,   667,  84075,  57407, 141482
186991,15048, 0.0000000, 0.0042067, 0.0020914,     0,   128,  30776,  30428,  61204
186992,15042, 0.0009634, 0.0454474, 0.0190130,    81,  2609,  84075,  57407, 141482
186993,15042, 0.0310080, 0.0072813, 0.0213808,  2607,   418,  84075,  57407, 141482
186994,15047, 0.0000000, 0.0134161, 0.0121105,     0,   836,   6718,  62313,  69031
186995,15047, 0.0000000, 0.0197712, 0.0178471,     0,  1232,   6718,  62313,  69031
186996,15047, 0.3161655, 0.0533115, 0.0788921,  2124,  3322,   6718,  62313,  69031
186997,15047, 0.0116106, 0.0907836, 0.0830786,    78,  5657,   6718,  62313,  69031
187004,15060, 0.0136683, 0.0267510, 0.0149263,  4529,   943, 331351,  35251, 366602
187006,15060, 0.0149268, 0.0205384, 0.0154664,  4946,   724, 331351,  35251, 366602
187007,15060, 0.0822874, 0.1492440, 0.0887256, 27266,  5261, 331351,  35251, 366602
187015,15020, 0.0562997, 1.0000000, 0.0566560, 15649,   105, 277959,    105, 278064
187016,15033, 0.0216191, 0.5604396, 0.0219744, 35780,   612,1655015,   1092,1656107
187017,15033, 0.0423223, 0.4395604, 0.0425842, 70044,   480,1655015,   1092,1656107
187021,15100, 0.1697629, 0.0257880, 0.1611978,  5620,    54,  33105,   2094,  35199
187022,15100, 0.3840205, 0.0759312, 0.3656922, 12713,   159,  33105,   2094,  35199
187022,15028, 0.0493396, 0.1173184, 0.0734985,   833,  1092,  16883,   9308,  26191
187023,15002, 0.0164993, 0.0724331, 0.0192080,  2144,   479, 129945,   6613, 136558
187024,15093, 0.0075428, 0.0159968, 0.0113441,   116,   201,  15379,  12565,  27944
187025,15093, 0.0000000, 0.0005571, 0.0002505,     0,     7,  15379,  12565,  27944
187027,15093, 0.0000000, 0.0006367, 0.0002863,     0,     8,  15379,  12565,  27944
187028,15093, 0.0000000, 0.0005571, 0.0002505,     0,     7,  15379,  12565,  27944
187029,15065, 0.0000000, 0.0031004, 0.0011977,     0,    41,  21008,  13224,  34232
187032,29006, 0.0000000, 0.3260918, 0.0649898,     0,  2912,  35877,   8930,  44807
187033,29006, 0.0877721, 0.1183651, 0.0938693,  3149,  1057,  35877,   8930,  44807
187034,29006, 0.5383672, 0.0040314, 0.4318745, 19315,    36,  35877,   8930,  44807
187035,29006, 0.0028709, 0.0027996, 0.0028567,   103,    25,  35877,   8930,  44807
187036,29006, 0.0000000, 0.0007839, 0.0001562,     0,     7,  35877,   8930,  44807
187038,29020, 0.1849148, 0.0225564, 0.1721737,  1444,    15,   7809,    665,   8474
187039,29020, 0.0000000, 0.7789474, 0.0611282,     0,   518,   7809,    665,   8474
187039,29045, 0.8912584, 0.4615385, 0.8902761,  5057,     6,   5674,     13,   5687
187042,29034, 0.0000000, 0.0009127, 0.0005008,     0,    20,  18026,  21913,  39939
187043,29034, 0.0000000, 0.0465021, 0.0255139,     0,  1019,  18026,  21913,  39939
187044,29034, 0.0000000, 0.0490120, 0.0268910,     0,  1074,  18026,  21913,  39939
187045,29003, 0.0000000, 0.0604912, 0.0556663,     0,   335,    480,   5538,   6018
187046,29003, 0.0000000, 0.0097508, 0.0089731,     0,    54,    480,   5538,   6018
187046,29034, 0.0000000, 0.0182996, 0.0100403,     0,   401,  18026,  21913,  39939
187047,29003, 0.0000000, 0.0754785, 0.0694583,     0,   418,    480,   5538,   6018
187048,29034, 0.0000000, 0.0002738, 0.0001502,     0,     6,  18026,  21913,  39939
187048,29003, 0.0000000, 0.0059588, 0.0054835,     0,    33,    480,   5538,   6018
187049,29034, 0.0061578, 0.0102222, 0.0083878,   111,   224,  18026,  21913,  39939
187050,29034, 0.0000000, 0.0375120, 0.0205814,     0,   822,  18026,  21913,  39939
187051,29034, 0.0006657, 0.0029663, 0.0019279,    12,    65,  18026,  21913,  39939
187052,29034, 0.0874293, 0.0031945, 0.0412129,  1576,    70,  18026,  21913,  39939
187053,29034, 0.0000000, 0.0093552, 0.0051328,     0,   205,  18026,  21913,  39939
187054,29034, 0.0000000, 0.0145576, 0.0079872,     0,   319,  18026,  21913,  39939
187055,29046, 0.0000000, 0.8311589, 0.2612156,     0,  1083,   2843,   1303,   4146
187056,29046, 0.0000000, 0.0276286, 0.0086831,     0,    36,   2843,   1303,   4146
187057,21083, 0.0000000, 0.0071606, 0.0070678,     0,   179,    328,  24998,  25326
187057,29046, 0.0000000, 0.0214889, 0.0067535,     0,    28,   2843,   1303,   4146
187058,29046, 0.0000000, 0.0053722, 0.0016884,     0,     7,   2843,   1303,   4146
187058,21083, 0.0000000, 0.0335227, 0.0330885,     0,   838,    328,  24998,  25326
187059,21083, 0.0000000, 0.0000800, 0.0000790,     0,     2,    328,  24998,  25326
187060,21083, 0.0000000, 0.0348828, 0.0344310,     0,   872,    328,  24998,  25326
187061,21083, 0.0000000, 0.0171614, 0.0169391,     0,   429,    328,  24998,  25326
187062,21083, 0.0000000, 0.0138011, 0.0136224,     0,   345,    328,  24998,  25326
187063,21083, 0.0000000, 0.0204416, 0.0201769,     0,   511,    328,  24998,  25326
187065,21105, 0.0000000, 0.0216475, 0.0159585,     0,    77,   1268,   3557,   4825
187066,21105, 0.0228707, 0.0368288, 0.0331606,    29,   131,   1268,   3557,   4825
188037,15124, 0.1703338, 0.0174927, 0.0286715,  1138,  1481,   6681,  84664,  91345
188038,15124, 0.0748391, 0.0317727, 0.0349225,   500,  2690,   6681,  84664,  91345
188039,15124, 0.0002994, 0.0415879, 0.0385681,     2,  3521,   6681,  84664,  91345
188040,15124, 0.0757372, 0.0207526, 0.0247742,   506,  1757,   6681,  84664,  91345
188040,15074, 0.0000000, 0.0050418, 0.0030726,     0,   373,  47414,  73982, 121396
188041,15074, 0.0000000, 0.0328053, 0.0199924,     0,  2427,  47414,  73982, 121396
188041,15124, 0.0000000, 0.0050317, 0.0046636,     0,   426,   6681,  84664,  91345
188042,15074, 0.0199730, 0.0145170, 0.0166480,   947,  1074,  47414,  73982, 121396
188044,15074, 0.0000000, 0.0185180, 0.0112854,     0,  1370,  47414,  73982, 121396
188045,15074, 0.0360442, 0.0379687, 0.0372170,  1709,  2809,  47414,  73982, 121396
188046,15074, 0.1178766, 0.0106783, 0.0525470,  5589,   790,  47414,  73982, 121396
188047,15074, 0.0039862, 0.0139493, 0.0100580,   189,  1032,  47414,  73982, 121396
188048,15042, 0.0224324, 0.0268086, 0.0242080,  1886,  1539,  84075,  57407, 141482
188049,15042, 0.0270711, 0.0270873, 0.0270776,  2276,  1555,  84075,  57407, 141482
188049,15048, 0.0000000, 0.0033850, 0.0016829,     0,   103,  30776,  30428,  61204
188051,15048, 0.0000000, 0.0159064, 0.0079080,     0,   484,  30776,  30428,  61204
188052,15048, 0.0000000, 0.0050283, 0.0024998,     0,   153,  30776,  30428,  61204
188053,15042, 0.0140351, 0.0133085, 0.0137403,  1180,   764,  84075,  57407, 141482
188053,15048, 0.0000000, 0.0140989, 0.0070093,     0,   429,  30776,  30428,  61204
188054,15047, 0.0000000, 0.0437950, 0.0395330,     0,  2729,   6718,  62313,  69031
188055,15047, 0.0000000, 0.0058575, 0.0052875,     0,   365,   6718,  62313,  69031
188056,15047, 0.0000000, 0.0127100, 0.0114731,     0,   792,   6718,  62313,  69031
188056,15056, 0.1285382, 0.0497650, 0.0843242,  1603,   794,  12471,  15955,  28426
188061,15112, 0.0000000, 0.0107568, 0.0075979,     0,   341,  13180,  31701,  44881
188062,15060, 0.0000000, 0.0226093, 0.0021740,     0,   797, 331351,  35251, 366602
188063,15060, 0.0151712, 0.0386088, 0.0174249,  5027,  1361, 331351,  35251, 366602
188063,15112, 0.0000000, 0.0016088, 0.0011363,     0,    51,  13180,  31701,  44881
188064,15060, 0.0095548, 0.0145244, 0.0100327,  3166,   512, 331351,  35251, 366602
188065,15060, 0.0283627, 0.0618138, 0.0315792,  9398,  2179, 331351,  35251, 366602
188066,15060, 0.0466182, 0.1639102, 0.0578966, 15447,  5778, 331351,  35251, 366602
188067,15095, 0.0000000, 0.0017408, 0.0002823,     0,    25,  74198,  14361,  88559
188068,15121, 0.0010299, 0.2186953, 0.0051576,   517,  2122, 501972,   9703, 511675
188079,15002, 0.0110354, 0.5331922, 0.0363216,  1434,  3526, 129945,   6613, 136558
188080,15002, 0.0489977, 0.0373507, 0.0484336,  6367,   247, 129945,   6613, 136558
188081,15002, 0.0608642, 0.0208680, 0.0589273,  7909,   138, 129945,   6613, 136558
188082,15002, 0.0490438, 0.0278240, 0.0480162,  6373,   184, 129945,   6613, 136558
188083,15093, 0.0000000, 0.0007163, 0.0003221,     0,     9,  15379,  12565,  27944
188083,15002, 0.0000000, 0.1226372, 0.0059389,     0,   811, 129945,   6613, 136558
188084,15075, 0.0000000, 0.1336490, 0.0647459,     0,  1609,  12812,  12039,  24851
188085,15065, 0.0012852, 0.1823956, 0.0712491,    27,  2412,  21008,  13224,  34232
188087,15065, 0.0000000, 0.0448427, 0.0173230,     0,   593,  21008,  13224,  34232
188088,15065, 0.0000000, 0.0117967, 0.0045571,     0,   156,  21008,  13224,  34232
188089,15065, 0.0000000, 0.0009831, 0.0003798,     0,    13,  21008,  13224,  34232
188092,29006, 0.0000000, 0.0005599, 0.0001116,     0,     5,  35877,   8930,  44807
188093,13021, 0.0000000, 0.0004315, 0.0001497,     0,     2,   8722,   4635,  13357
188094,29006, 0.0000000, 0.0016797, 0.0003348,     0,    15,  35877,   8930,  44807
188094,13008, 0.0000000, 0.0001884, 0.0000705,     0,     3,  26642,  15921,  42563
188095,13008, 0.0000000, 0.0694680, 0.0259850,     0,  1106,  26642,  15921,  42563
188097,13008, 0.0000000, 0.0257522, 0.0096328,     0,   410,  26642,  15921,  42563
188099,13008, 0.0000000, 0.0473588, 0.0177149,     0,   754,  26642,  15921,  42563
188101,29034, 0.0000000, 0.0006389, 0.0003505,     0,    14,  18026,  21913,  39939
188103,29034, 0.0000000, 0.0002282, 0.0001252,     0,     5,  18026,  21913,  39939
188105,29034, 0.0000000, 0.0095834, 0.0052580,     0,   210,  18026,  21913,  39939
188106,29034, 0.0000000, 0.0072560, 0.0039811,     0,   159,  18026,  21913,  39939
188107,29034, 0.0000000, 0.0130060, 0.0071359,     0,   285,  18026,  21913,  39939
188108,29034, 0.3761234, 0.0073929, 0.1738151,  6780,   162,  18026,  21913,  39939
188109,29034, 0.3299123, 0.0019167, 0.1499537,  5947,    42,  18026,  21913,  39939
188110,29034, 0.0000000, 0.0318532, 0.0174767,     0,   698,  18026,  21913,  39939
188111,29034, 0.0905359, 0.0024187, 0.0421893,  1632,    53,  18026,  21913,  39939
188112,29034, 0.0000000, 0.0005933, 0.0003255,     0,    13,  18026,  21913,  39939
188113,29034, 0.0000000, 0.0148770, 0.0081624,     0,   326,  18026,  21913,  39939
188114,29046, 0.0000000, 0.0168841, 0.0053063,     0,    22,   2843,   1303,   4146
188114,29034, 0.0000000, 0.0071647, 0.0039310,     0,   157,  18026,  21913,  39939
188114,21083, 0.0000000, 0.0013201, 0.0013030,     0,    33,    328,  24998,  25326
188115,21083, 0.0000000, 0.0105608, 0.0104241,     0,   264,    328,  24998,  25326
188117,21083, 0.0000000, 0.0393231, 0.0388139,     0,   983,    328,  24998,  25326
188118,21083, 0.0000000, 0.0504840, 0.0498302,     0,  1262,    328,  24998,  25326
188119,21083, 0.0945122, 0.0020402, 0.0032378,    31,    51,    328,  24998,  25326
188120,21083, 0.0000000, 0.0050004, 0.0049356,     0,   125,    328,  24998,  25326
188121,21083, 0.0000000, 0.0306425, 0.0302456,     0,   766,    328,  24998,  25326
188122,21083, 0.0000000, 0.0468838, 0.0462766,     0,  1172,    328,  24998,  25326
188123,21083, 0.0000000, 0.0518041, 0.0511332,     0,  1295,    328,  24998,  25326
188124,21044, 0.0000000, 0.2680341, 0.1760266,     0,  2705,   5275,  10092,  15367
188125,21044, 0.0039810, 0.0009909, 0.0020173,    21,    10,   5275,  10092,  15367
188126,21044, 0.3567773, 0.0300238, 0.1421878,  1882,   303,   5275,  10092,  15367
189096,15124, 0.0000000, 0.0182840, 0.0169467,     0,  1548,   6681,  84664,  91345
189097,15124, 0.0000000, 0.0241189, 0.0223548,     0,  2042,   6681,  84664,  91345
189098,15124, 0.0000000, 0.0257016, 0.0238218,     0,  2176,   6681,  84664,  91345
189099,15124, 0.0000000, 0.0133114, 0.0123378,     0,  1127,   6681,  84664,  91345
189100,15074, 0.0000000, 0.0239383, 0.0145886,     0,  1771,  47414,  73982, 121396
189101,15074, 0.0000000, 0.0144089, 0.0087812,     0,  1066,  47414,  73982, 121396
189102,15074, 0.0063483, 0.0361710, 0.0245230,   301,  2676,  47414,  73982, 121396
189103,15074, 0.0578310, 0.0224514, 0.0362697,  2742,  1661,  47414,  73982, 121396
189104,15074, 0.0251403, 0.0034603, 0.0119279,  1192,   256,  47414,  73982, 121396
189105,15074, 0.0142996, 0.0025412, 0.0071337,   678,   188,  47414,  73982, 121396
189106,15042, 0.0056259, 0.0778999, 0.0349514,   473,  4472,  84075,  57407, 141482
189108,15048, 0.0000000, 0.0177468, 0.0088230,     0,   540,  30776,  30428,  61204
189108,15042, 0.0626583, 0.0033620, 0.0385985,  5268,   193,  84075,  57407, 141482
189109,15048, 0.0000000, 0.0187327, 0.0093131,     0,   570,  30776,  30428,  61204
189110,15048, 0.1110931, 0.0039437, 0.0578230,  3419,   120,  30776,  30428,  61204
189111,15048, 0.0012022, 0.0760484, 0.0384125,    37,  2314,  30776,  30428,  61204
189112,15048, 0.0000000, 0.0265545, 0.0132018,     0,   808,  30776,  30428,  61204
189112,15047, 0.0000000, 0.0001444, 0.0001304,     0,     9,   6718,  62313,  69031
189113,15047, 0.0000000, 0.0190650, 0.0172097,     0,  1188,   6718,  62313,  69031
189114,15047, 0.0000000, 0.0084573, 0.0076343,     0,   527,   6718,  62313,  69031
189115,15056, 0.0109855, 0.0421185, 0.0284599,   137,   672,  12471,  15955,  28426
189115,15112, 0.0000000, 0.1242863, 0.0877877,     0,  3940,  13180,  31701,  44881
189116,15056, 0.0125090, 0.0192416, 0.0162879,   156,   307,  12471,  15955,  28426
189117,15112, 0.0000000, 0.0026182, 0.0018493,     0,    83,  13180,  31701,  44881
189117,15056, 0.0000000, 0.0005641, 0.0003166,     0,     9,  12471,  15955,  28426
189119,15112, 0.0000000, 0.0583262, 0.0411978,     0,  1849,  13180,  31701,  44881
189120,15112, 0.0000000, 0.0881360, 0.0622535,     0,  2794,  13180,  31701,  44881
189121,15112, 0.0515933, 0.0053311, 0.0189167,   680,   169,  13180,  31701,  44881
189122,15112, 0.0000000, 0.0189268, 0.0133687,     0,   600,  13180,  31701,  44881
189122,15060, 0.0000000, 0.0202264, 0.0019449,     0,   713, 331351,  35251, 366602
189123,15060, 0.0024294, 0.0168222, 0.0038134,   805,   593, 331351,  35251, 366602
189124,15060, 0.0061657, 0.1219540, 0.0172994,  2043,  4299, 331351,  35251, 366602
189125,15095, 0.0000000, 0.0014623, 0.0002371,     0,    21,  74198,  14361,  88559
189125,15060, 0.0000785, 0.0011915, 0.0001855,    26,    42, 331351,  35251, 366602
189126,15095, 0.0054988, 0.0170601, 0.0073736,   408,   245,  74198,  14361,  88559
189127,15060, 0.0002897, 0.0090210, 0.0011293,    96,   318, 331351,  35251, 366602
189127,15095, 0.0215909, 0.0329364, 0.0234307,  1602,   473,  74198,  14361,  88559
189128,15121, 0.0567641, 0.3072246, 0.0615137, 28494,  2981, 501972,   9703, 511675
189132,15108, 0.2905485, 0.1186047, 0.2865219, 26050,   255,  89658,   2150,  91808
189133,15109, 0.0984181, 0.1494881, 0.0987036, 51290,   438, 521144,   2930, 524074
189133,15108, 0.0414575, 0.5372093, 0.0530673,  3717,  1155,  89658,   2150,  91808
189135,15125, 0.0000000, 0.0037769, 0.0012725,     0,    13,   6774,   3442,  10216
189136,15081, 0.0798920, 0.0321695, 0.0788910, 28516,   246, 356932,   7647, 364579
189137,15081, 0.0876049, 0.0682621, 0.0871992, 31269,   522, 356932,   7647, 364579
189139,15002, 0.0298203, 0.0176924, 0.0292330,  3875,   117, 129945,   6613, 136558
189139,15081, 0.0000000, 0.0408003, 0.0008558,     0,   312, 356932,   7647, 364579
189140,15002, 0.0308284, 0.0957206, 0.0339709,  4006,   633, 129945,   6613, 136558
189140,15092, 0.1159492, 0.0902425, 0.1107904,  4913,   960,  42372,  10638,  53010
189141,15002, 0.0112817, 0.0597308, 0.0136279,  1466,   395, 129945,   6613, 136558
189142,15092, 0.0074342, 0.0973867, 0.0254858,   315,  1036,  42372,  10638,  53010
189143,15065, 0.0000000, 0.0006050, 0.0002337,     0,     8,  21008,  13224,  34232
189144,15065, 0.1453732, 0.0020417, 0.0900035,  3054,    27,  21008,  13224,  34232
189145,15065, 0.0000000, 0.2175590, 0.0840442,     0,  2877,  21008,  13224,  34232
189146,15065, 0.0000000, 0.0113430, 0.0043819,     0,   150,  21008,  13224,  34232
189147,15065, 0.0000000, 0.0029492, 0.0011393,     0,    39,  21008,  13224,  34232
189151,13021, 0.0000000, 0.0008630, 0.0002995,     0,     4,   8722,   4635,  13357
189152,13021, 0.1581059, 0.3836030, 0.2363555,  1379,  1778,   8722,   4635,  13357
189153,13021, 0.8418941, 0.0040992, 0.5511717,  7343,    19,   8722,   4635,  13357
189153,13008, 0.0000000, 0.0000628, 0.0000235,     0,     1,  26642,  15921,  42563
189154,13008, 0.0000000, 0.1484203, 0.0555177,     0,  2363,  26642,  15921,  42563
189155,13008, 0.0000000, 0.1498650, 0.0560581,     0,  2386,  26642,  15921,  42563
189156,13008, 0.0000000, 0.0005025, 0.0001880,     0,     8,  26642,  15921,  42563
189157,13007, 0.0000000, 0.0010783, 0.0006198,     0,     7,   4802,   6492,  11294
189158,13007, 0.0000000, 0.0009242, 0.0005313,     0,     6,   4802,   6492,  11294
189159,29034, 0.0000000, 0.0000456, 0.0000250,     0,     1,  18026,  21913,  39939
189159,13007, 0.0000000, 0.0021565, 0.0012396,     0,    14,   4802,   6492,  11294
189160,29034, 0.0000000, 0.1046411, 0.0574126,     0,  2293,  18026,  21913,  39939
189161,29034, 0.0000000, 0.0145576, 0.0079872,     0,   319,  18026,  21913,  39939
189162,29034, 0.0000000, 0.1086570, 0.0596159,     0,  2381,  18026,  21913,  39939
189164,29034, 0.0000000, 0.0002738, 0.0001502,     0,     6,  18026,  21913,  39939
189165,29034, 0.0000000, 0.0005020, 0.0002754,     0,    11,  18026,  21913,  39939
189166,29034, 0.0000000, 0.0005476, 0.0003005,     0,    12,  18026,  21913,  39939
189168,29034, 0.0629091, 0.0014147, 0.0291695,  1134,    31,  18026,  21913,  39939
189169,29034, 0.0000000, 0.0000913, 0.0000501,     0,     2,  18026,  21913,  39939
189171,21083, 0.0000000, 0.0148412, 0.0146490,     0,   371,    328,  24998,  25326
189172,21083, 0.0000000, 0.0000800, 0.0000790,     0,     2,    328,  24998,  25326
189173,21083, 0.0000000, 0.0012401, 0.0012240,     0,    31,    328,  24998,  25326
189174,21083, 0.0000000, 0.0378030, 0.0373134,     0,   945,    328,  24998,  25326
189175,21083, 0.0000000, 0.0119210, 0.0117666,     0,   298,    328,  24998,  25326
189176,21083, 0.0000000, 0.0026002, 0.0025665,     0,    65,    328,  24998,  25326
189177,21083, 0.0000000, 0.0035603, 0.0035142,     0,    89,    328,  24998,  25326
189178,21083, 0.9054878, 0.0102808, 0.0218748,   297,   257,    328,  24998,  25326
189179,21083, 0.0000000, 0.0076806, 0.0075811,     0,   192,    328,  24998,  25326
189181,21083, 0.0000000, 0.0110009, 0.0108584,     0,   275,    328,  24998,  25326
189183,21044, 0.0000000, 0.0006936, 0.0004555,     0,     7,   5275,  10092,  15367
189185,21044, 0.0000000, 0.2173999, 0.1427735,     0,  2194,   5275,  10092,  15367
190155,15124, 0.0000000, 0.0231503, 0.0214571,     0,  1960,   6681,  84664,  91345
190155,16093, 0.0000000, 0.0012055, 0.0010512,     0,    29,   3530,  24057,  27587
190156,15124, 0.1827571, 0.0269772, 0.0383710,  1221,  2284,   6681,  84664,  91345
190157,15124, 0.0902560, 0.0470094, 0.0501724,   603,  3980,   6681,  84664,  91345
190158,15124, 0.0000000, 0.0178470, 0.0165417,     0,  1511,   6681,  84664,  91345
190159,15074, 0.0000000, 0.0666784, 0.0406356,     0,  4933,  47414,  73982, 121396
190160,15074, 0.0000000, 0.0068936, 0.0042011,     0,   510,  47414,  73982, 121396
190161,15074, 0.0000000, 0.0159633, 0.0097285,     0,  1181,  47414,  73982, 121396
190162,15074, 0.0225461, 0.0683004, 0.0504300,  1069,  5053,  47414,  73982, 121396
190163,15074, 0.0964905, 0.0581898, 0.0731490,  4575,  4305,  47414,  73982, 121396
190164,15074, 0.0109883, 0.0077316, 0.0090036,   521,   572,  47414,  73982, 121396
190165,15042, 0.0424740, 0.0257808, 0.0357007,  3571,  1480,  84075,  57407, 141482
190166,15042, 0.0168421, 0.0291950, 0.0218544,  1416,  1676,  84075,  57407, 141482
190166,15048, 0.0000000, 0.0000986, 0.0000490,     0,     3,  30776,  30428,  61204
190167,15048, 0.0000000, 0.0897529, 0.0446213,     0,  2731,  30776,  30428,  61204
190168,15048, 0.2039251, 0.0486723, 0.1267401,  6276,  1481,  30776,  30428,  61204
190169,15048, 0.0264167, 0.0681938, 0.0471865,   813,  2075,  30776,  30428,  61204
190170,15048, 0.0000000, 0.0796635, 0.0396053,     0,  2424,  30776,  30428,  61204
190171,15048, 0.0577723, 0.0376298, 0.0477583,  1778,  1145,  30776,  30428,  61204
190172,15048, 0.0108201, 0.0452215, 0.0279230,   333,  1376,  30776,  30428,  61204
190173,15056, 0.0000000, 0.0021310, 0.0011961,     0,    34,  12471,  15955,  28426
190175,15056, 0.0708845, 0.0090254, 0.0361641,   884,   144,  12471,  15955,  28426
190176,15056, 0.0000000, 0.0075212, 0.0042215,     0,   120,  12471,  15955,  28426
190177,15112, 0.0000000, 0.0093057, 0.0065729,     0,   295,  13180,  31701,  44881
190177,15056, 0.0000000, 0.0122219, 0.0068599,     0,   195,  12471,  15955,  28426
190178,15112, 0.0000000, 0.0817324, 0.0577304,     0,  2591,  13180,  31701,  44881
190179,15112, 0.0000000, 0.0666225, 0.0470578,     0,  2112,  13180,  31701,  44881
190180,15112, 0.2823976, 0.0114507, 0.0910185,  3722,   363,  13180,  31701,  44881
190181,15112, 0.0000000, 0.0138481, 0.0097814,     0,   439,  13180,  31701,  44881
190182,15095, 0.0000000, 0.0075204, 0.0012195,     0,   108,  74198,  14361,  88559
190183,15060, 0.0095096, 0.1419818, 0.0222476,  3151,  5005, 331351,  35251, 366602
190184,15095, 0.0430066, 0.0233967, 0.0398266,  3191,   336,  74198,  14361,  88559
190184,15060, 0.0053870, 0.0139854, 0.0062138,  1785,   493, 331351,  35251, 366602
190185,15095, 0.0291113, 0.1210222, 0.0440159,  2160,  1738,  74198,  14361,  88559
190186,15121, 0.0003725, 0.0545192, 0.0013993,   187,   529, 501972,   9703, 511675
190186,15095, 0.0757028, 0.0862057, 0.0774060,  5617,  1238,  74198,  14361,  88559
190187,15095, 0.0938570, 0.1389179, 0.1011642,  6964,  1995,  74198,  14361,  88559
190187,15121, 0.0224275, 0.4195610, 0.0299585, 11258,  4071, 501972,   9703, 511675
190190,15024, 0.1914449, 0.2191402, 0.1940896, 24253,  2931, 126684,  13375, 140059
190190,15053, 0.0443377, 0.0009757, 0.0372611,  1864,     8,  42041,   8199,  50240
190192,15109, 0.0436636, 0.1109215, 0.0440396, 22755,   325, 521144,   2930, 524074
190192,15059, 0.0000000, 0.1307244, 0.0411066,     0,  1413,  23565,  10809,  34374
190192,15108, 0.2071315, 0.3441860, 0.2103412, 18571,   740,  89658,   2150,  91808
190192,15053, 0.0000000, 0.8469325, 0.1382166,     0,  6944,  42041,   8199,  50240
190193,15059, 0.0756631, 0.1989083, 0.1144179,  1783,  2150,  23565,  10809,  34374
190193,15125, 0.0000000, 0.8370134, 0.2820086,     0,  2881,   6774,   3442,  10216
190194,15081, 0.0121564, 0.0104616, 0.0121208,  4339,    80, 356932,   7647, 364579
190194,15125, 1.0000000, 0.1592098, 0.7167189,  6774,   548,   6774,   3442,  10216
190194,15059, 0.0000000, 0.0032380, 0.0010182,     0,    35,  23565,  10809,  34374
190195,15081, 0.0604233, 0.0404080, 0.0600035, 21567,   309, 356932,   7647, 364579
190197,15081, 0.0907344, 0.0179155, 0.0892070, 32386,   137, 356932,   7647, 364579
190198,15002, 0.0018546, 0.0125510, 0.0023726,   241,    83, 129945,   6613, 136558
190198,15092, 0.0000000, 0.2393307, 0.0480287,     0,  2546,  42372,  10638,  53010
190199,15092, 0.0447937, 0.2243843, 0.0808338,  1898,  2387,  42372,  10638,  53010
190200,15092, 0.3902577, 0.0628878, 0.3245614, 16536,   669,  42372,  10638,  53010
190201,15092, 0.2645379, 0.0203986, 0.2155442, 11209,   217,  42372,  10638,  53010
190202,15092, 0.0505995, 0.0574356, 0.0519713,  2144,   611,  42372,  10638,  53010
190202,15075, 0.1052919, 0.0010798, 0.0548066,  1349,    13,  12812,  12039,  24851
190203,15075, 0.0000000, 0.0012460, 0.0006036,     0,    15,  12812,  12039,  24851
190203,15065, 0.1217631, 0.0038566, 0.0762152,  2558,    51,  21008,  13224,  34232
190204,15065, 0.1442784, 0.1423926, 0.1435499,  3031,  1883,  21008,  13224,  34232
190205,15065, 0.0157559, 0.1312765, 0.0603821,   331,  1736,  21008,  13224,  34232
190206,15065, 0.0000000, 0.1617514, 0.0624854,     0,  2139,  21008,  13224,  34232
190207,15065, 0.0000000, 0.0223079, 0.0086177,     0,   295,  21008,  13224,  34232
190210,13021, 0.0000000, 0.2720604, 0.0944074,     0,  1261,   8722,   4635,  13357
190213,13008, 0.0000000, 0.0334778, 0.0125226,     0,   533,  26642,  15921,  42563
190215,13008, 0.0000000, 0.0421456, 0.0157649,     0,   671,  26642,  15921,  42563
190216,13008, 0.0000000, 0.0003141, 0.0001175,     0,     5,  26642,  15921,  42563
190217,13007, 0.0000000, 0.1568084, 0.0901364,     0,  1018,   4802,   6492,  11294
190218,13007, 0.0000000, 0.0742452, 0.0426775,     0,   482,   4802,   6492,  11294
190219,13007, 0.0000000, 0.0006161, 0.0003542,     0,     4,   4802,   6492,  11294
190219,29034, 0.0000000, 0.0005933, 0.0003255,     0,    13,  18026,  21913,  39939
190220,29034, 0.0000000, 0.0070278, 0.0038559,     0,   154,  18026,  21913,  39939
190222,29034, 0.0000000, 0.0317620, 0.0174266,     0,   696,  18026,  21913,  39939
190223,29034, 0.0000000, 0.1080637, 0.0592904,     0,  2368,  18026,  21913,  39939
190225,29034, 0.0000000, 0.1087026, 0.0596410,     0,  2382,  18026,  21913,  39939
190227,29034, 0.0000000, 0.0000456, 0.0000250,     0,     1,  18026,  21913,  39939
190227,21053, 0.0000000, 0.0076411, 0.0046798,     0,   271,  22443,  35466,  57909
190228,29034, 0.0000000, 0.0005020, 0.0002754,     0,    11,  18026,  21913,  39939
190230,21083, 0.0000000, 0.0002400, 0.0002369,     0,     6,    328,  24998,  25326
190231,21083, 0.0000000, 0.0584447, 0.0576878,     0,  1461,    328,  24998,  25326
190232,21083, 0.0000000, 0.0172414, 0.0170181,     0,   431,    328,  24998,  25326
190233,21083, 0.0000000, 0.0028802, 0.0028429,     0,    72,    328,  24998,  25326
190234,21083, 0.0000000, 0.0029202, 0.0028824,     0,    73,    328,  24998,  25326
190235,21083, 0.0000000, 0.0172414, 0.0170181,     0,   431,    328,  24998,  25326
190236,21083, 0.0000000, 0.0066005, 0.0065150,     0,   165,    328,  24998,  25326
190238,21083, 0.0000000, 0.0060405, 0.0059623,     0,   151,    328,  24998,  25326
190239,21083, 0.0000000, 0.0062805, 0.0061992,     0,   157,    328,  24998,  25326
190241,21212, 0.0000000, 0.0530961, 0.0399218,     0,   776,   4823,  14615,  19438
190243,21212, 0.0000000, 0.0057475, 0.0043214,     0,    84,   4823,  14615,  19438
190244,21044, 0.0000000, 0.0282402, 0.0185462,     0,   285,   5275,  10092,  15367
190244,21212, 0.0000000, 0.0032843, 0.0024694,     0,    48,   4823,  14615,  19438
191214,16093, 0.0000000, 0.0381178, 0.0332403,     0,   917,   3530,  24057,  27587
191215,15064, 0.0000000, 0.0027206, 0.0022644,     0,    78,   5776,  28670,  34446
191216,15124, 0.0264930, 0.0317372, 0.0313537,   177,  2687,   6681,  84664,  91345
191216,15064, 0.0000000, 0.0176840, 0.0147187,     0,   507,   5776,  28670,  34446
191217,15124, 0.0000000, 0.0272371, 0.0252450,     0,  2306,   6681,  84664,  91345
191218,15074, 0.0000000, 0.0079479, 0.0048437,     0,   588,  47414,  73982, 121396
191219,15074, 0.0000000, 0.0335217, 0.0204290,     0,  2480,  47414,  73982, 121396
191219,15048, 0.0000000, 0.0029249, 0.0014542,     0,    89,  30776,  30428,  61204
191220,15074, 0.0000000, 0.0470114, 0.0286500,     0,  3478,  47414,  73982, 121396
191221,15074, 0.0042603, 0.0198967, 0.0137896,   202,  1472,  47414,  73982, 121396
191222,15074, 0.0122959, 0.0056365, 0.0082375,   583,   417,  47414,  73982, 121396
191223,15074, 0.0000000, 0.0268173, 0.0163432,     0,  1984,  47414,  73982, 121396
191223,15048, 0.0000000, 0.0001643, 0.0000817,     0,     5,  30776,  30428,  61204
191225,15048, 0.0000000, 0.0239911, 0.0119273,     0,   730,  30776,  30428,  61204
191226,15048, 0.0000000, 0.1277771, 0.0635253,     0,  3888,  30776,  30428,  61204
191227,15048, 0.0308357, 0.0082490, 0.0196066,   949,   251,  30776,  30428,  61204
191230,15048, 0.0000000, 0.0451229, 0.0224332,     0,  1373,  30776,  30428,  61204
191231,15048, 0.0000000, 0.0117326, 0.0058330,     0,   357,  30776,  30428,  61204
191231,15056, 0.0000000, 0.0223128, 0.0125237,     0,   356,  12471,  15955,  28426
191232,15056, 0.0000000, 0.0544657, 0.0305706,     0,   869,  12471,  15955,  28426
191233,15056, 0.1705557, 0.0080226, 0.0793288,  2127,   128,  12471,  15955,  28426
191234,15056, 0.0635073, 0.2240677, 0.1536270,   792,  3575,  12471,  15955,  28426
191236,15112, 0.0000000, 0.0282010, 0.0199193,     0,   894,  13180,  31701,  44881
191237,15112, 0.0000000, 0.0368758, 0.0260467,     0,  1169,  13180,  31701,  44881
191238,15112, 0.2507587, 0.0000631, 0.0736837,  3305,     2,  13180,  31701,  44881
191239,15112, 0.3475721, 0.0293051, 0.1227691,  4581,   929,  13180,  31701,  44881
191240,15112, 0.0000000, 0.0670641, 0.0473697,     0,  2126,  13180,  31701,  44881
191241,15095, 0.0000000, 0.0385071, 0.0062444,     0,   553,  74198,  14361,  88559
191243,15095, 0.0023990, 0.0905229, 0.0166894,   178,  1300,  74198,  14361,  88559
191244,15095, 0.0000000, 0.0042476, 0.0006888,     0,    61,  74198,  14361,  88559
191245,15095, 0.0000000, 0.0017408, 0.0002823,     0,    25,  74198,  14361,  88559
191246,15095, 0.0473867, 0.0820277, 0.0530042,  3516,  1178,  74198,  14361,  88559
191247,15095, 0.3330548, 0.0616252, 0.2890390, 24712,   885,  74198,  14361,  88559
191248,15024, 0.0000000, 0.1857944, 0.0177425,     0,  2485, 126684,  13375, 140059
191249,15024, 0.0086278, 0.2983178, 0.0362918,  1093,  3990, 126684,  13375, 140059
191249,15053, 0.0251421, 0.0003659, 0.0210987,  1057,     3,  42041,   8199,  50240
191250,15053, 0.4799362, 0.1492865, 0.4259753, 20177,  1224,  42041,   8199,  50240
191250,15024, 0.0000000, 0.0115140, 0.0010995,     0,   154, 126684,  13375, 140059
191251,15059, 0.0000000, 0.0186881, 0.0058765,     0,   202,  23565,  10809,  34374
191251,15053, 0.0777574, 0.0024393, 0.0654658,  3269,    20,  42041,   8199,  50240
191252,15059, 0.1450881, 0.3954112, 0.2238029,  3419,  4274,  23565,  10809,  34374
191253,15059, 0.1562062, 0.0041632, 0.1083959,  3681,    45,  23565,  10809,  34374
191254,15081, 0.0000000, 0.0014385, 0.0000302,     0,    11, 356932,   7647, 364579
191255,15081, 0.0038523, 0.0214463, 0.0042213,  1375,   164, 356932,   7647, 364579
191256,15081, 0.0381950, 0.2828560, 0.0433267, 13633,  2163, 356932,   7647, 364579
191257,15081, 0.0011963, 0.0007846, 0.0011877,   427,     6, 356932,   7647, 364579
191258,15092, 0.0000000, 0.0575296, 0.0115450,     0,   612,  42372,  10638,  53010
191259,15092, 0.0000000, 0.0007520, 0.0001509,     0,     8,  42372,  10638,  53010
191259,15075, 0.0000000, 0.0285738, 0.0138425,     0,   344,  12812,  12039,  24851
191260,15092, 0.0000000, 0.0539575, 0.0108281,     0,   574,  42372,  10638,  53010
191260,15075, 0.4836872, 0.2864856, 0.3881534,  6197,  3449,  12812,  12039,  24851
191261,15075, 0.3360131, 0.0318133, 0.1886443,  4305,   383,  12812,  12039,  24851
191262,15075, 0.0000000, 0.1601462, 0.0775824,     0,  1928,  12812,  12039,  24851
191262,15065, 0.1220011, 0.0144434, 0.0804510,  2563,   191,  21008,  13224,  34232
191263,15016, 0.1081787, 0.0292568, 0.0753551,  1615,   311,  14929,  10630,  25559
191263,15065, 0.2847963, 0.0252571, 0.1845349,  5983,   334,  21008,  13224,  34232
191264,15065, 0.0537414, 0.0014368, 0.0335359,  1129,    19,  21008,  13224,  34232
191264,15016, 0.0036841, 0.0022578, 0.0030909,    55,    24,  14929,  10630,  25559
191266,15016, 0.0000000, 0.0029163, 0.0012129,     0,    31,  14929,  10630,  25559
191269,13021, 0.0000000, 0.3389428, 0.1176162,     0,  1571,   8722,   4635,  13357
191270,13061, 0.0000000, 0.0002543, 0.0000387,     0,     2,  43800,   7864,  51664
191271,13008, 0.0000000, 0.0523208, 0.0195710,     0,   833,  26642,  15921,  42563
191272,13008, 0.0000000, 0.0005025, 0.0001880,     0,     8,  26642,  15921,  42563
191273,13008, 0.0576533, 0.0255009, 0.0456265,  1536,   406,  26642,  15921,  42563
191274,13008, 0.8290669, 0.0357390, 0.5323168, 22088,   569,  26642,  15921,  42563
191274,13007, 0.0000000, 0.1320086, 0.0758810,     0,   857,   4802,   6492,  11294
191275,13008, 0.0000000, 0.0021355, 0.0007988,     0,    34,  26642,  15921,  42563
191275,13007, 0.5056227, 0.0070856, 0.2190544,  2428,    46,   4802,   6492,  11294
191276,13007, 0.4943773, 0.0468269, 0.2371171,  2374,   304,   4802,   6492,  11294
191277,13007, 0.0000000, 0.0009242, 0.0005313,     0,     6,   4802,   6492,  11294
191278,13007, 0.0000000, 0.1155268, 0.0664069,     0,   750,   4802,   6492,  11294
191279,29034, 0.0000000, 0.0202163, 0.0110919,     0,   443,  18026,  21913,  39939
191286,29034, 0.0000000, 0.0000456, 0.0000250,     0,     1,  18026,  21913,  39939
191287,29034, 0.0000000, 0.0006389, 0.0003505,     0,    14,  18026,  21913,  39939
191287,21053, 0.0000000, 0.0062595, 0.0038336,     0,   222,  22443,  35466,  57909
191289,21083, 0.0000000, 0.0371630, 0.0366817,     0,   929,    328,  24998,  25326
191290,21083, 0.0000000, 0.0102008, 0.0100687,     0,   255,    328,  24998,  25326
191291,21083, 0.0000000, 0.0033603, 0.0033167,     0,    84,    328,  24998,  25326
191292,21083, 0.0000000, 0.0047204, 0.0046592,     0,   118,    328,  24998,  25326
191295,21083, 0.0000000, 0.0225218, 0.0222301,     0,   563,    328,  24998,  25326
191296,21083, 0.0000000, 0.0116809, 0.0115297,     0,   292,    328,  24998,  25326
191297,21083, 0.0000000, 0.0244420, 0.0241254,     0,   611,    328,  24998,  25326
191299,21212, 0.0000000, 0.0777284, 0.0584422,     0,  1136,   4823,  14615,  19438
191300,21212, 0.0000000, 0.0838864, 0.0630723,     0,  1226,   4823,  14615,  19438
191301,21212, 0.0000000, 0.0091687, 0.0068937,     0,   134,   4823,  14615,  19438
191302,21212, 0.0000000, 0.0433801, 0.0326165,     0,   634,   4823,  14615,  19438
191303,21212, 0.0000000, 0.0338693, 0.0254656,     0,   495,   4823,  14615,  19438
191303,21044, 0.0000000, 0.0004954, 0.0003254,     0,     5,   5275,  10092,  15367
192273,16093, 0.0000000, 0.0539968, 0.0470874,     0,  1299,   3530,  24057,  27587
192274,15064, 0.0000000, 0.0332403, 0.0276665,     0,   953,   5776,  28670,  34446
192274,16093, 0.0000000, 0.0432722, 0.0377352,     0,  1041,   3530,  24057,  27587
192275,15124, 0.0000000, 0.0021024, 0.0019487,     0,   178,   6681,  84664,  91345
192275,15064, 0.0000000, 0.0593303, 0.0493816,     0,  1701,   5776,  28670,  34446
192276,15074, 0.0000000, 0.0071774, 0.0043741,     0,   531,  47414,  73982, 121396
192276,15124, 0.0000000, 0.0031182, 0.0028901,     0,   264,   6681,  84664,  91345
192276,15064, 0.0000000, 0.0384723, 0.0320211,     0,  1103,   5776,  28670,  34446
192278,15074, 0.0000000, 0.0057987, 0.0035339,     0,   429,  47414,  73982, 121396
192278,15064, 0.0000000, 0.0425532, 0.0354178,     0,  1220,   5776,  28670,  34446
192280,15048, 0.1224331, 0.1809189, 0.1515097,  3768,  5505,  30776,  30428,  61204
192282,15048, 0.1453080, 0.0362166, 0.0910725,  4472,  1102,  30776,  30428,  61204
192283,15014, 0.0000000, 0.0065059, 0.0031371,     0,   294,  48528,  45190,  93718
192284,15048, 0.0000000, 0.0079861, 0.0039703,     0,   243,  30776,  30428,  61204
192284,15014, 0.0000000, 0.0000221, 0.0000107,     0,     1,  48528,  45190,  93718
192285,15014, 0.0900923, 0.0487055, 0.0701359,  4372,  2201,  48528,  45190,  93718
192287,15014, 0.0000206, 0.0401859, 0.0193880,     1,  1816,  48528,  45190,  93718
192290,15056, 0.1811402, 0.0187402, 0.0899880,  2259,   299,  12471,  15955,  28426
192291,15056, 0.0336781, 0.0029458, 0.0164286,   420,    47,  12471,  15955,  28426
192292,15056, 0.0000000, 0.0083359, 0.0046788,     0,   133,  12471,  15955,  28426
192293,15026, 0.0000000, 0.0189356, 0.0101630,     0,   280,  12764,  14787,  27551
192294,15026, 0.0000000, 0.0242781, 0.0130304,     0,   359,  12764,  14787,  27551
192295,15026, 0.0000000, 0.0507202, 0.0272222,     0,   750,  12764,  14787,  27551
192296,15026, 0.0000000, 0.0144722, 0.0077674,     0,   214,  12764,  14787,  27551
192297,15112, 0.0000000, 0.0118293, 0.0083554,     0,   375,  13180,  31701,  44881
192298,15112, 0.0676783, 0.0046371, 0.0231501,   892,   147,  13180,  31701,  44881
192299,15112, 0.0000000, 0.0135012, 0.0095363,     0,   428,  13180,  31701,  44881
192305,15095, 0.0001213, 0.0440081, 0.0072381,     9,   632,  74198,  14361,  88559
192306,15095, 0.0067252, 0.1199777, 0.0250906,   499,  1723,  74198,  14361,  88559
192306,15091, 0.0000000, 0.3533724, 0.0305474,     0,  1928,  57659,   5456,  63115
192307,15024, 0.0000000, 0.2471028, 0.0235972,     0,  3305, 126684,  13375, 140059
192307,15095, 0.0080999, 0.0003482, 0.0068429,   601,     5,  74198,  14361,  88559
192308,15024, 0.0005683, 0.0058318, 0.0010710,    72,    78, 126684,  13375, 140059
192309,15024, 0.0237125, 0.0322991, 0.0245325,  3004,   432, 126684,  13375, 140059
192309,15059, 0.0000000, 0.0020353, 0.0006400,     0,    22,  23565,  10809,  34374
192310,15059, 0.0539784, 0.0137848, 0.0413394,  1272,   149,  23565,  10809,  34374
192311,15059, 0.5244642, 0.0098992, 0.3626578, 12359,   107,  23565,  10809,  34374
192315,15081, 0.0135908, 0.0647313, 0.0146635,  4851,   495, 356932,   7647, 364579
192316,15081, 0.0012495, 0.0653851, 0.0025948,   446,   500, 356932,   7647, 364579
192316,15084, 0.0000000, 0.2652776, 0.0580210,     0,  2088,  28116,   7871,  35987
192317,15092, 0.0000000, 0.0686219, 0.0137710,     0,   730,  42372,  10638,  53010
192317,15084, 0.0000000, 0.0006352, 0.0001389,     0,     5,  28116,   7871,  35987
192318,15092, 0.0000000, 0.0270728, 0.0054329,     0,   288,  42372,  10638,  53010
192318,15075, 0.0000000, 0.1534181, 0.0743230,     0,  1847,  12812,  12039,  24851
192319,15075, 0.0000000, 0.1535842, 0.0744034,     0,  1849,  12812,  12039,  24851
192321,15075, 0.0000000, 0.0098845, 0.0047885,     0,   119,  12812,  12039,  24851
192321,15065, 0.1110053, 0.0196612, 0.0757186,  2332,   260,  21008,  13224,  34232
192321,15016, 0.0000000, 0.1134525, 0.0471849,     0,  1206,  14929,  10630,  25559
192322,15016, 0.1005426, 0.1083725, 0.1037991,  1501,  1152,  14929,  10630,  25559
192322,15075, 0.0000000, 0.0069773, 0.0033801,     0,    84,  12812,  12039,  24851
192323,15016, 0.0103155, 0.0764817, 0.0378340,   154,   813,  14929,  10630,  25559
192323,15061, 0.0000000, 0.8466300, 0.1383924,     0,  1231,   7441,   1454,   8895
192324,15016, 0.0000000, 0.0011289, 0.0004695,     0,    12,  14929,  10630,  25559
192325,15016, 0.0000000, 0.0605833, 0.0251966,     0,   644,  14929,  10630,  25559
192326,15016, 0.2337732, 0.0031044, 0.1378379,  3490,    33,  14929,  10630,  25559
192328,13061, 0.0000000, 0.2236775, 0.0340469,     0,  1759,  43800,   7864,  51664
192329,13061, 0.0000000, 0.1191506, 0.0181364,     0,   937,  43800,   7864,  51664
192330,13061, 0.0000000, 0.0020346, 0.0003097,     0,    16,  43800,   7864,  51664
192331,13008, 0.0000000, 0.1150682, 0.0430421,     0,  1832,  26642,  15921,  42563
192332,13008, 0.0000000, 0.0150744, 0.0056387,     0,   240,  26642,  15921,  42563
192333,13008, 0.1132798, 0.0283902, 0.0815262,  3018,   452,  26642,  15921,  42563
192334,13007, 0.0000000, 0.0009242, 0.0005313,     0,     6,   4802,   6492,  11294
192334,13008, 0.0000000, 0.0022612, 0.0008458,     0,    36,  26642,  15921,  42563
192335,13007, 0.0000000, 0.0020025, 0.0011511,     0,    13,   4802,   6492,  11294
192336,13007, 0.0000000, 0.0001540, 0.0000885,     0,     1,   4802,   6492,  11294
192338,29034, 0.0000000, 0.0000456, 0.0000250,     0,     1,  18026,  21913,  39939
192338,13007, 0.0000000, 0.0224892, 0.0129272,     0,   146,   4802,   6492,  11294
192339,29034, 0.0000000, 0.0150596, 0.0082626,     0,   330,  18026,  21913,  39939
192339,13007, 0.0000000, 0.0167899, 0.0096511,     0,   109,   4802,   6492,  11294
192342,21053, 0.0000000, 0.0418147, 0.0256091,     0,  1483,  22443,  35466,  57909
192343,21053, 0.0000000, 0.0224440, 0.0137457,     0,   796,  22443,  35466,  57909
192345,21053, 0.0000000, 0.0031862, 0.0019513,     0,   113,  22443,  35466,  57909
192346,21053, 0.0000000, 0.0447471, 0.0274051,     0,  1587,  22443,  35466,  57909
192348,21083, 0.0000000, 0.0034403, 0.0033957,     0,    86,    328,  24998,  25326
192350,21016, 0.0000000, 0.0202965, 0.0179664,     0,   141,    901,   6947,   7848
192351,21083, 0.0000000, 0.0046404, 0.0045803,     0,   116,    328,  24998,  25326
192352,21083, 0.0000000, 0.0082407, 0.0081339,     0,   206,    328,  24998,  25326
192354,21083, 0.0000000, 0.0133611, 0.0131880,     0,   334,    328,  24998,  25326
192355,21172, 0.0000000, 0.0011210, 0.0009305,     0,    24,   4383,  21410,  25793
192356,21172, 0.0000000, 0.0142924, 0.0118637,     0,   306,   4383,  21410,  25793
192359,21212, 0.0000000, 0.0136161, 0.0102377,     0,   199,   4823,  14615,  19438
192360,21212, 0.1273067, 0.0345535, 0.0575676,   614,   505,   4823,  14615,  19438
192361,21212, 0.0000000, 0.1063291, 0.0799465,     0,  1554,   4823,  14615,  19438
192362,21212, 0.3647107, 0.1035922, 0.1683815,  1759,  1514,   4823,  14615,  19438
193332,16093, 0.0889518, 0.0966039, 0.0956247,   314,  2324,   3530,  24057,  27587
193333,15064, 0.6632618, 0.0445413, 0.1482901,  3831,  1277,   5776,  28670,  34446
193333,16093, 0.0000000, 0.0078563, 0.0068511,     0,   189,   3530,  24057,  27587
193334,15064, 0.0000000, 0.1653296, 0.1376067,     0,  4740,   5776,  28670,  34446
193335,15064, 0.0000000, 0.0144402, 0.0120188,     0,   414,   5776,  28670,  34446
193336,15064, 0.0000000, 0.1525288, 0.1269523,     0,  4373,   5776,  28670,  34446
193337,15064, 0.0000000, 0.0717824, 0.0597457,     0,  2058,   5776,  28670,  34446
193338,15064, 0.0000000, 0.0748518, 0.0623004,     0,  2146,   5776,  28670,  34446
193340,15048, 0.1583702, 0.0000329, 0.0796517,  4874,     1,  30776,  30428,  61204
193341,15014, 0.0000000, 0.0000885, 0.0000427,     0,     4,  48528,  45190,  93718
193342,15014, 0.1930226, 0.0009294, 0.1003969,  9367,    42,  48528,  45190,  93718
193343,15014, 0.0949349, 0.0716309, 0.0836979,  4607,  3237,  48528,  45190,  93718
193344,15014, 0.0703099, 0.0363355, 0.0539277,  3412,  1642,  48528,  45190,  93718
193345,15014, 0.0167532, 0.0014384, 0.0093685,   813,    65,  48528,  45190,  93718
193346,15014, 0.1207962, 0.0020137, 0.0635203,  5862,    91,  48528,  45190,  93718
193347,15056, 0.0000000, 0.0314635, 0.0176599,     0,   502,  12471,  15955,  28426
193349,15056, 0.1525940, 0.0554058, 0.0980440,  1903,   884,  12471,  15955,  28426
193350,15056, 0.0247775, 0.1126293, 0.0740871,   309,  1797,  12471,  15955,  28426
193351,15056, 0.0000000, 0.0108430, 0.0060860,     0,   173,  12471,  15955,  28426
193352,15026, 0.0000000, 0.0119700, 0.0064244,     0,   177,  12764,  14787,  27551
193354,15026, 0.0000000, 0.0150132, 0.0080578,     0,   222,  12764,  14787,  27551
193356,15112, 0.0000000, 0.0144159, 0.0101825,     0,   457,  13180,  31701,  44881
193356,15026, 0.0000000, 0.0088591, 0.0047548,     0,   131,  12764,  14787,  27551
193357,15112, 0.0000000, 0.0098735, 0.0069740,     0,   313,  13180,  31701,  44881
193358,15112, 0.0000000, 0.0322703, 0.0227936,     0,  1023,  13180,  31701,  44881
193359,15112, 0.0000000, 0.0156777, 0.0110737,     0,   497,  13180,  31701,  44881
193361,15095, 0.0000000, 0.0004874, 0.0000790,     0,     7,  74198,  14361,  88559
193361,15035, 0.0000000, 0.0054348, 0.0005799,     0,    58,  89351,  10672, 100023
193365,15095, 0.1762716, 0.1262447, 0.1681591, 13079,  1813,  74198,  14361,  88559
193366,15091, 0.0785827, 0.0951246, 0.0800127,  4531,   519,  57659,   5456,  63115
193366,15023, 0.3608768, 0.7617059, 0.3953113, 12875,  2554,  35677,   3353,  39030
193367,15091, 0.1030368, 0.5515029, 0.1418046,  5941,  3009,  57659,   5456,  63115
193368,15059, 0.0000000, 0.0054584, 0.0017164,     0,    59,  23565,  10809,  34374
193368,15120, 0.0000000, 0.0318918, 0.0050674,     0,   809, 134280,  25367, 159647
193369,15059, 0.0000000, 0.0014802, 0.0004655,     0,    16,  23565,  10809,  34374
193369,15120, 0.0711200, 0.0105255, 0.0614919,  9550,   267, 134280,  25367, 159647
193370,15120, 0.0096515, 0.0960697, 0.0233828,  1296,  2437, 134280,  25367, 159647
193371,15059, 0.0000000, 0.2162087, 0.0679874,     0,  2337,  23565,  10809,  34374
193371,15120, 0.0206509, 0.0485276, 0.0250803,  2773,  1231, 134280,  25367, 159647
193372,15081, 0.0026280, 0.2876945, 0.0086072,   938,  2200, 356932,   7647, 364579
193374,15081, 0.0398759, 0.0519158, 0.0401285, 14233,   397, 356932,   7647, 364579
193375,15081, 0.0010086, 0.0023539, 0.0010368,   360,    18, 356932,   7647, 364579
193377,15075, 0.0000000, 0.0331423, 0.0160557,     0,   399,  12812,  12039,  24851
193377,15084, 0.1398492, 0.0052090, 0.1104010,  3932,    41,  28116,   7871,  35987
193379,15084, 0.0000000, 0.0957947, 0.0209520,     0,   754,  28116,   7871,  35987
193381,15016, 0.0474915, 0.0488241, 0.0480457,   709,   519,  14929,  10630,  25559
193382,15061, 0.0365542, 0.0061898, 0.0315908,   272,     9,   7441,   1454,   8895
193383,15016, 0.0000000, 0.0353716, 0.0147111,     0,   376,  14929,  10630,  25559
193385,15016, 0.0000000, 0.0859831, 0.0357604,     0,   914,  14929,  10630,  25559
193388,13061, 0.1555936, 0.0104273, 0.1334972,  6815,    82,  43800,   7864,  51664
193390,13008, 0.0000000, 0.0655738, 0.0245283,     0,  1044,  26642,  15921,  42563
193390,13061, 0.0000000, 0.1210580, 0.0184268,     0,   952,  43800,   7864,  51664
193391,13008, 0.0000000, 0.0011934, 0.0004464,     0,    19,  26642,  15921,  42563
193392,13008, 0.0000000, 0.0028265, 0.0010573,     0,    45,  26642,  15921,  42563
193393,13008, 0.0000000, 0.0106149, 0.0039706,     0,   169,  26642,  15921,  42563
193394,13007, 0.0000000, 0.0007702, 0.0004427,     0,     5,   4802,   6492,  11294
193394,13008, 0.0000000, 0.0006281, 0.0002349,     0,    10,  26642,  15921,  42563
193395,13007, 0.0000000, 0.1001232, 0.0575527,     0,   650,   4802,   6492,  11294
193396,13007, 0.0000000, 0.0195625, 0.0112449,     0,   127,   4802,   6492,  11294
193397,13007, 0.0000000, 0.0160197, 0.0092084,     0,   104,   4802,   6492,  11294
193398,13007, 0.0000000, 0.1192237, 0.0685320,     0,   774,   4802,   6492,  11294
193401,21053, 0.0000000, 0.0110810, 0.0067865,     0,   393,  22443,  35466,  57909
193402,21053, 0.0000000, 0.0120115, 0.0073564,     0,   426,  22443,  35466,  57909
193403,21053, 0.0000000, 0.0296904, 0.0181837,     0,  1053,  22443,  35466,  57909
193404,21053, 0.0000000, 0.0055546, 0.0034019,     0,   197,  22443,  35466,  57909
193405,21053, 0.0000000, 0.0596346, 0.0365228,     0,  2115,  22443,  35466,  57909
193408,21016, 0.0000000, 0.0971642, 0.0860092,     0,   675,    901,   6947,   7848
193409,21016, 0.0000000, 0.0981719, 0.0869011,     0,   682,    901,   6947,   7848
193410,21016, 0.0000000, 0.0924140, 0.0818043,     0,   642,    901,   6947,   7848
193411,21016, 0.0000000, 0.0287894, 0.0254842,     0,   200,    901,   6947,   7848
193414,21172, 0.0000000, 0.0211583, 0.0175629,     0,   453,   4383,  21410,  25793
193416,21172, 0.0000000, 0.0016815, 0.0013957,     0,    36,   4383,  21410,  25793
193417,21212, 0.0000000, 0.0112898, 0.0084885,     0,   165,   4823,  14615,  19438
193418,21212, 0.0000000, 0.0346220, 0.0260315,     0,   506,   4823,  14615,  19438
193419,21212, 0.0000000, 0.0145056, 0.0109065,     0,   212,   4823,  14615,  19438
193420,21212, 0.0000000, 0.0310640, 0.0233563,     0,   454,   4823,  14615,  19438
193421,21212, 0.0000000, 0.0568594, 0.0427513,     0,   831,   4823,  14615,  19438
193421,21207, 0.0260205, 0.0039642, 0.0149545,   691,   106,  26556,  26739,  53295
194391,16093, 0.8235127, 0.0411938, 0.1412984,  2907,   991,   3530,  24057,  27587
194392,15064, 0.3310249, 0.0284967, 0.0792255,  1912,   817,   5776,  28670,  34446
194393,15064, 0.0057133, 0.0171957, 0.0152703,    33,   493,   5776,  28670,  34446
194394,15064, 0.0000000, 0.1183816, 0.0985310,     0,  3394,   5776,  28670,  34446
194395,15064, 0.0000000, 0.0090687, 0.0075480,     0,   260,   5776,  28670,  34446
194396,15064, 0.0000000, 0.0137775, 0.0114672,     0,   395,   5776,  28670,  34446
194396,15085, 0.0000000, 0.0081341, 0.0045139,     0,   283,  27903,  34792,  62695
194397,15064, 0.0000000, 0.0459016, 0.0382047,     0,  1316,   5776,  28670,  34446
194397,15085, 0.0905637, 0.0072143, 0.0443098,  2527,   251,  27903,  34792,  62695
194399,15014, 0.0000000, 0.0441691, 0.0212979,     0,  1996,  48528,  45190,  93718
194400,15014, 0.1380234, 0.0608099, 0.1007917,  6698,  2748,  48528,  45190,  93718
194401,15014, 0.2143711, 0.1463156, 0.1815553, 10403,  6612,  48528,  45190,  93718
194402,15014, 0.0325379, 0.0571808, 0.0444205,  1579,  2584,  48528,  45190,  93718
194403,15014, 0.0000000, 0.0195397, 0.0094219,     0,   883,  48528,  45190,  93718
194404,15014, 0.0000000, 0.0071255, 0.0034358,     0,   322,  48528,  45190,  93718
194405,15014, 0.0000206, 0.0013277, 0.0006509,     1,    60,  48528,  45190,  93718
194405,15102, 0.0000000, 0.1630473, 0.1526866,     0,  2350,    978,  14413,  15391
194406,15056, 0.0000000, 0.0750862, 0.0421445,     0,  1198,  12471,  15955,  28426
194407,15056, 0.0000000, 0.2156691, 0.1210511,     0,  3441,  12471,  15955,  28426
194409,15056, 0.0205276, 0.0054528, 0.0120664,   256,    87,  12471,  15955,  28426
194411,15026, 0.0000000, 0.0479475, 0.0257341,     0,   709,  12764,  14787,  27551
194412,15026, 0.0000000, 0.1191587, 0.0639541,     0,  1762,  12764,  14787,  27551
194413,15026, 0.0555468, 0.0762156, 0.0666400,   709,  1127,  12764,  14787,  27551
194414,15026, 0.0160608, 0.0244133, 0.0205437,   205,   361,  12764,  14787,  27551
194415,15026, 0.0000000, 0.0455130, 0.0244274,     0,   673,  12764,  14787,  27551
194416,15112, 0.0000000, 0.0150784, 0.0106504,     0,   478,  13180,  31701,  44881
194417,15112, 0.0000000, 0.0041639, 0.0029411,     0,   132,  13180,  31701,  44881
194418,15112, 0.0000000, 0.0490205, 0.0346249,     0,  1554,  13180,  31701,  44881
194419,13063, 0.0000000, 0.0669265, 0.0208778,     0,  1683,  55465,  25147,  80612
194421,13063, 0.0024159, 0.0002784, 0.0017491,   134,     7,  55465,  25147,  80612
194422,15035, 0.0148627, 0.0006559, 0.0133469,  1328,     7,  89351,  10672, 100023
194423,15023, 0.0000000, 0.0017894, 0.0001537,     0,     6,  35677,   3353,  39030
194423,15035, 0.0000000, 0.0020615, 0.0002199,     0,    22,  89351,  10672, 100023
194424,15023, 0.0454354, 0.1297346, 0.0526774,  1621,   435,  35677,   3353,  39030
194425,15023, 0.0619166, 0.1067701, 0.0657699,  2209,   358,  35677,   3353,  39030
194430,15120, 0.0306896, 0.1136910, 0.0438781,  4121,  2884, 134280,  25367, 159647
194431,15120, 0.0429401, 0.0495131, 0.0439845,  5766,  1256, 134280,  25367, 159647
194432,15081, 0.0044182, 0.0057539, 0.0044462,  1577,    44, 356932,   7647, 364579
194432,15120, 0.0022043, 0.0007884, 0.0019794,   296,    20, 134280,  25367, 159647
194433,15081, 0.0002129, 0.0056231, 0.0003264,    76,    43, 356932,   7647, 364579
194433,15120, 0.0000000, 0.0603934, 0.0095962,     0,  1532, 134280,  25367, 159647
194434,15084, 0.0000000, 0.0085123, 0.0018618,     0,    67,  28116,   7871,  35987
194435,15084, 0.0000000, 0.0039385, 0.0008614,     0,    31,  28116,   7871,  35987
194436,15084, 0.0050505, 0.1236183, 0.0309834,   142,   973,  28116,   7871,  35987
194437,15084, 0.0910514, 0.1226020, 0.0979520,  2560,   965,  28116,   7871,  35987
194439,15016, 0.0255208, 0.0005644, 0.0151414,   381,     6,  14929,  10630,  25559
194441,15061, 0.0306410, 0.0041265, 0.0263069,   228,     6,   7441,   1454,   8895
194442,15061, 0.5579895, 0.0309491, 0.4718381,  4152,    45,   7441,   1454,   8895
194443,15016, 0.0000000, 0.0325494, 0.0135373,     0,   346,  14929,  10630,  25559
194444,15016, 0.0000000, 0.0106303, 0.0044211,     0,   113,  14929,  10630,  25559
194445,15016, 0.0000000, 0.0425212, 0.0176846,     0,   452,  14929,  10630,  25559
194445,13072, 0.0000000, 0.0003663, 0.0000976,     0,     1,   7518,   2730,  10248
194446,13072, 0.0003990, 0.5164835, 0.1378805,     3,  1410,   7518,   2730,  10248
194446,13061, 0.1175114, 0.0006358, 0.0997213,  5147,     5,  43800,   7864,  51664
194447,13061, 0.4303881, 0.0006358, 0.3649737, 18851,     5,  43800,   7864,  51664
194448,13061, 0.0174429, 0.0170397, 0.0173815,   764,   134,  43800,   7864,  51664
194449,13061, 0.0000000, 0.0316633, 0.0048196,     0,   249,  43800,   7864,  51664
194450,13008, 0.0000000, 0.0011306, 0.0004229,     0,    18,  26642,  15921,  42563
194450,13061, 0.0000000, 0.0001272, 0.0000194,     0,     1,  43800,   7864,  51664
194451,13008, 0.0000000, 0.0262546, 0.0098207,     0,   418,  26642,  15921,  42563
194452,13008, 0.0000000, 0.0070975, 0.0026549,     0,   113,  26642,  15921,  42563
194453,13008, 0.0000000, 0.0193455, 0.0072363,     0,   308,  26642,  15921,  42563
194454,13007, 0.0000000, 0.0343500, 0.0197450,     0,   223,   4802,   6492,  11294
194454,13008, 0.0000000, 0.0009422, 0.0003524,     0,    15,  26642,  15921,  42563
194455,13007, 0.0000000, 0.0138632, 0.0079688,     0,    90,   4802,   6492,  11294
194456,13007, 0.0000000, 0.0021565, 0.0012396,     0,    14,   4802,   6492,  11294
194457,13007, 0.0000000, 0.0092421, 0.0053126,     0,    60,   4802,   6492,  11294
194458,13007, 0.0000000, 0.0021565, 0.0012396,     0,    14,   4802,   6492,  11294
194460,21053, 0.0000000, 0.0136187, 0.0083407,     0,   483,  22443,  35466,  57909
194461,21053, 0.0000000, 0.0048497, 0.0029702,     0,   172,  22443,  35466,  57909
194462,21053, 0.0000000, 0.0186094, 0.0113972,     0,   660,  22443,  35466,  57909
194463,21053, 0.0000000, 0.0417301, 0.0255573,     0,  1480,  22443,  35466,  57909
194464,21053, 0.0000000, 0.0115886, 0.0070973,     0,   411,  22443,  35466,  57909
194465,21053, 0.0000000, 0.0488355, 0.0299090,     0,  1732,  22443,  35466,  57909
194466,21053, 0.0000000, 0.0257148, 0.0157488,     0,   912,  22443,  35466,  57909
194468,21016, 0.0000000, 0.1904419, 0.1685780,     0,  1323,    901,   6947,   7848
194469,21016, 0.0000000, 0.0585864, 0.0518603,     0,   407,    901,   6947,   7848
194470,21016, 0.0000000, 0.0148265, 0.0131244,     0,   103,    901,   6947,   7848
194472,21172, 0.0000000, 0.0083139, 0.0069011,     0,   178,   4383,  21410,  25793
194473,21172, 0.0000000, 0.0038767, 0.0032179,     0,    83,   4383,  21410,  25793
194475,21172, 0.0000000, 0.0107894, 0.0089559,     0,   231,   4383,  21410,  25793
194476,21212, 0.0000000, 0.0252480, 0.0189834,     0,   369,   4823,  14615,  19438
194477,21212, 0.0000000, 0.0313377, 0.0235621,     0,   458,   4823,  14615,  19438
194479,21212, 0.0000000, 0.0702703, 0.0528347,     0,  1027,   4823,  14615,  19438
194480,21212, 0.0000000, 0.0150530, 0.0113180,     0,   220,   4823,  14615,  19438
194480,21207, 0.0530953, 0.0130147, 0.0329862,  1410,   348,  26556,  26739,  53295
195450,16093, 0.0000000, 0.0181652, 0.0158408,     0,   437,   3530,  24057,  27587
195451,15064, 0.0000000, 0.0115452, 0.0096092,     0,   331,   5776,  28670,  34446
195451,16017, 0.0000000, 0.0012165, 0.0010621,     0,    35,   4184,  28770,  32954
195453,15064, 0.0000000, 0.0189745, 0.0157928,     0,   544,   5776,  28670,  34446
195453,15085, 0.0000000, 0.0052311, 0.0029029,     0,   182,  27903,  34792,  62695
195454,15064, 0.0000000, 0.0191838, 0.0159670,     0,   550,   5776,  28670,  34446
195454,15085, 0.0000000, 0.0615084, 0.0341335,     0,  2140,  27903,  34792,  62695
195455,15085, 0.0000000, 0.0328236, 0.0182152,     0,  1142,  27903,  34792,  62695
195456,15085, 0.0962979, 0.0238273, 0.0560810,  2687,   829,  27903,  34792,  62695
195457,15085, 0.0416443, 0.0488905, 0.0456655,  1162,  1701,  27903,  34792,  62695
195458,15014, 0.0000000, 0.0494800, 0.0238588,     0,  2236,  48528,  45190,  93718
195459,15014, 0.0177217, 0.0360699, 0.0265691,   860,  1630,  48528,  45190,  93718
195460,15014, 0.0000000, 0.0666962, 0.0321603,     0,  3014,  48528,  45190,  93718
195461,15014, 0.0000000, 0.0030980, 0.0014938,     0,   140,  48528,  45190,  93718
195462,15014, 0.0000000, 0.0001106, 0.0000534,     0,     5,  48528,  45190,  93718
195463,15014, 0.0000000, 0.0016154, 0.0007789,     0,    73,  48528,  45190,  93718
195463,15001, 0.0000000, 0.0011255, 0.0009685,     0,    59,   8499,  52419,  60918
195464,15102, 0.0000000, 0.0133907, 0.0125398,     0,   193,    978,  14413,  15391
195465,15102, 0.0000000, 0.0670228, 0.0627640,     0,   966,    978,  14413,  15391
195466,15056, 0.0000000, 0.0119712, 0.0067192,     0,   191,  12471,  15955,  28426
195471,15026, 0.0575838, 0.0960979, 0.0782549,   735,  1421,  12764,  14787,  27551
195472,15026, 0.0000000, 0.0261716, 0.0140467,     0,   387,  12764,  14787,  27551
195474,15026, 0.0000000, 0.0110908, 0.0059526,     0,   164,  12764,  14787,  27551
195475,15026, 0.0000000, 0.0261716, 0.0140467,     0,   387,  12764,  14787,  27551
195475,15112, 0.0000000, 0.0111038, 0.0078430,     0,   352,  13180,  31701,  44881
195476,15112, 0.0000000, 0.0879152, 0.0620975,     0,  2787,  13180,  31701,  44881
195477,15112, 0.0000000, 0.0676635, 0.0477931,     0,  2145,  13180,  31701,  44881
195478,13063, 0.0000000, 0.0001988, 0.0000620,     0,     5,  55465,  25147,  80612
195479,13063, 0.0577481, 0.0610013, 0.0587630,  3203,  1534,  55465,  25147,  80612
195480,13063, 0.0037681, 0.0687557, 0.0240411,   209,  1729,  55465,  25147,  80612
195481,15035, 0.0267484, 0.3936469, 0.0658948,  2390,  4201,  89351,  10672, 100023
195481,13063, 0.0000000, 0.0009544, 0.0002977,     0,    24,  55465,  25147,  80612
195482,15035, 0.1527235, 0.2323838, 0.1612229, 13646,  2480,  89351,  10672, 100023
195483,15035, 0.1765957, 0.2658358, 0.1861172, 15779,  2837,  89351,  10672, 100023
195484,15035, 0.3077190, 0.0019678, 0.2750967, 27495,    21,  89351,  10672, 100023
195485,15120, 0.0341823, 0.0251508, 0.0327473,  4590,   638, 134280,  25367, 159647
195486,15120, 0.0534033, 0.1660819, 0.0713073,  7171,  4213, 134280,  25367, 159647
195486,15096, 0.0000000, 0.2619098, 0.0368066,     0,  1248,  29142,   4765,  33907
195487,15120, 0.0380399, 0.0335869, 0.0373324,  5108,   852, 134280,  25367, 159647
195488,15120, 0.0846887, 0.0298419, 0.0759739, 11372,   757, 134280,  25367, 159647
195489,15120, 0.0198913, 0.0025230, 0.0171315,  2671,    64, 134280,  25367, 159647
195490,15120, 0.0414879, 0.0468719, 0.0423434,  5571,  1189, 134280,  25367, 159647
195491,15120, 0.0139708, 0.0473450, 0.0192738,  1876,  1201, 134280,  25367, 159647
195493,13069, 0.0079891, 0.0013628, 0.0074902,   720,    10,  90123,   7338,  97461
195493,15084, 0.0006758, 0.0452293, 0.0104204,    19,   356,  28116,   7871,  35987
195494,15084, 0.1996017, 0.0120696, 0.1585850,  5612,    95,  28116,   7871,  35987
195495,15084, 0.0199886, 0.0011434, 0.0158668,   562,     9,  28116,   7871,  35987
195496,15084, 0.0328283, 0.0059713, 0.0269542,   923,    47,  28116,   7871,  35987
195499,15016, 0.0000000, 0.0648166, 0.0269572,     0,   689,  14929,  10630,  25559
195499,15061, 0.0000000, 0.0027510, 0.0004497,     0,     4,   7441,   1454,   8895
195503,15061, 0.0000000, 0.0041265, 0.0006745,     0,     6,   7441,   1454,   8895
195504,13072, 0.4326949, 0.2791209, 0.3917838,  3253,   762,   7518,   2730,  10248
195505,13072, 0.5505453, 0.0007326, 0.4040788,  4139,     2,   7518,   2730,  10248
195506,13061, 0.0000000, 0.0041963, 0.0006387,     0,    33,  43800,   7864,  51664
195507,13061, 0.0000000, 0.1574263, 0.0239625,     0,  1238,  43800,   7864,  51664
195508,13061, 0.0000000, 0.0010173, 0.0001548,     0,     8,  43800,   7864,  51664
195509,13061, 0.0000000, 0.0204730, 0.0031163,     0,   161,  43800,   7864,  51664
195510,13061, 0.0000000, 0.0012716, 0.0001936,     0,    10,  43800,   7864,  51664
195511,13008, 0.0000000, 0.0018843, 0.0007048,     0,    30,  26642,  15921,  42563
195511,13061, 0.0000000, 0.0218718, 0.0033292,     0,   172,  43800,   7864,  51664
195512,13008, 0.0000000, 0.0205389, 0.0076827,     0,   327,  26642,  15921,  42563
195513,13008, 0.0000000, 0.0033289, 0.0012452,     0,    53,  26642,  15921,  42563
195514,13007, 0.0000000, 0.0030807, 0.0017709,     0,    20,   4802,   6492,  11294
195515,13007, 0.0000000, 0.0035428, 0.0020365,     0,    23,   4802,   6492,  11294
195516,13007, 0.0000000, 0.0842576, 0.0484328,     0,   547,   4802,   6492,  11294
195517,13007, 0.0000000, 0.0036969, 0.0021250,     0,    24,   4802,   6492,  11294
195517,21053, 0.0000000, 0.0045678, 0.0027975,     0,   162,  22443,  35466,  57909
195518,21053, 0.0000000, 0.0128292, 0.0078572,     0,   455,  22443,  35466,  57909
195519,21053, 0.0000000, 0.0034117, 0.0020895,     0,   121,  22443,  35466,  57909
195520,21053, 0.0000000, 0.0028478, 0.0017441,     0,   101,  22443,  35466,  57909
195521,21053, 0.0000000, 0.0079513, 0.0048697,     0,   282,  22443,  35466,  57909
195522,21053, 0.0000000, 0.0122653, 0.0075118,     0,   435,  22443,  35466,  57909
195524,21053, 0.0000000, 0.0450854, 0.0276123,     0,  1599,  22443,  35466,  57909
195525,21053, 0.0000000, 0.0354142, 0.0216892,     0,  1256,  22443,  35466,  57909
195527,21016, 0.2241953, 0.0071974, 0.0321101,   202,    50,    901,   6947,   7848
195528,21016, 0.7758046, 0.2599683, 0.3191896,   699,  1806,    901,   6947,   7848
195529,21016, 0.0000000, 0.0637685, 0.0564475,     0,   443,    901,   6947,   7848
195529,21172, 0.0000000, 0.0211583, 0.0175629,     0,   453,   4383,  21410,  25793
195530,21016, 0.0000000, 0.0195768, 0.0173293,     0,   136,    901,   6947,   7848
195530,21172, 0.0000000, 0.0081738, 0.0067848,     0,   175,   4383,  21410,  25793
195531,21172, 0.0000000, 0.0134050, 0.0111271,     0,   287,   4383,  21410,  25793
195532,21172, 0.1713438, 0.0435311, 0.0652503,   751,   932,   4383,  21410,  25793
195533,21172, 0.0000000, 0.0382532, 0.0317528,     0,   819,   4383,  21410,  25793
195534,21172, 0.0000000, 0.0304064, 0.0252394,     0,   651,   4383,  21410,  25793
195536,21212, 0.0000000, 0.0138214, 0.0103920,     0,   202,   4823,  14615,  19438
195537,21212, 0.0000000, 0.0263428, 0.0198066,     0,   385,   4823,  14615,  19438
195537,21200, 0.0000000, 0.0383128, 0.0278701,     0,   109,   1066,   2845,   3911
195538,21212, 0.0000000, 0.0405748, 0.0305073,     0,   593,   4823,  14615,  19438
195538,21200, 0.0000000, 0.0007030, 0.0005114,     0,     2,   1066,   2845,   3911
195538,21207, 0.0000000, 0.0200830, 0.0100760,     0,   537,  26556,  26739,  53295
196509,16017, 0.0000000, 0.0547793, 0.0478242,     0,  1576,   4184,  28770,  32954
196510,16017, 0.0000000, 0.0706986, 0.0617224,     0,  2034,   4184,  28770,  32954
196511,16017, 0.0000000, 0.0480709, 0.0419676,     0,  1383,   4184,  28770,  32954
196511,15085, 0.0000000, 0.0031042, 0.0017226,     0,   108,  27903,  34792,  62695
196513,15085, 0.0076694, 0.0767993, 0.0460324,   214,  2672,  27903,  34792,  62695
196514,15085, 0.1265814, 0.0138538, 0.0640242,  3532,   482,  27903,  34792,  62695
196515,15085, 0.0000000, 0.0547252, 0.0303692,     0,  1904,  27903,  34792,  62695
196516,15085, 0.0000000, 0.0093412, 0.0051838,     0,   325,  27903,  34792,  62695
196517,15014, 0.0000000, 0.0949325, 0.0457756,     0,  4290,  48528,  45190,  93718
196518,15014, 0.0000000, 0.1621819, 0.0782027,     0,  7329,  48528,  45190,  93718
196519,15014, 0.0000000, 0.0083426, 0.0040227,     0,   377,  48528,  45190,  93718
196520,15014, 0.0000000, 0.0230139, 0.0110971,     0,  1040,  48528,  45190,  93718
196521,15001, 0.0000000, 0.0001717, 0.0001477,     0,     9,   8499,  52419,  60918
196522,15001, 0.0000000, 0.0285011, 0.0245248,     0,  1494,   8499,  52419,  60918
196523,15102, 0.0000000, 0.0354541, 0.0332012,     0,   511,    978,  14413,  15391
196524,15102, 0.7617587, 0.0712551, 0.1151322,   745,  1027,    978,  14413,  15391
196525,15102, 0.0000000, 0.0255325, 0.0239101,     0,   368,    978,  14413,  15391
196526,15102, 0.0000000, 0.1276625, 0.1195504,     0,  1840,    978,  14413,  15391
196527,15102, 0.0000000, 0.0058975, 0.0055227,     0,    85,    978,  14413,  15391
196528,15026, 0.3020213, 0.0906878, 0.1885957,  3855,  1341,  12764,  14787,  27551
196529,15026, 0.1990755, 0.0616758, 0.1253312,  2541,   912,  12764,  14787,  27551
196530,15026, 0.0613444, 0.0082505, 0.0328482,   783,   122,  12764,  14787,  27551
196531,15026, 0.0000000, 0.0751336, 0.0403252,     0,  1111,  12764,  14787,  27551
196532,15026, 0.0000000, 0.0104146, 0.0055896,     0,   154,  12764,  14787,  27551
196535,13063, 0.0000000, 0.0003977, 0.0001241,     0,    10,  55465,  25147,  80612
196537,13063, 0.0000000, 0.1580308, 0.0492979,     0,  3974,  55465,  25147,  80612
196537,15112, 0.0000000, 0.0083909, 0.0059268,     0,   266,  13180,  31701,  44881
196538,13063, 0.0014964, 0.0172585, 0.0064134,    83,   434,  55465,  25147,  80612
196539,13063, 0.0000000, 0.0002784, 0.0000868,     0,     7,  55465,  25147,  80612
196542,15035, 0.1284037, 0.0855510, 0.1238315, 11473,   913,  89351,  10672, 100023
196543,15035, 0.0158588, 0.0004685, 0.0142167,  1417,     5,  89351,  10672, 100023
196544,15096, 0.0000000, 0.0008395, 0.0001180,     0,     4,  29142,   4765,  33907
196546,15120, 0.0177093, 0.1245319, 0.0346828,  2378,  3159, 134280,  25367, 159647
196547,15120, 0.0012437, 0.0905901, 0.0154403,   167,  2298, 134280,  25367, 159647
196549,13069, 0.0000000, 0.0014990, 0.0001129,     0,    11,  90123,   7338,  97461
196550,13069, 0.1640647, 0.0610521, 0.1563087, 14786,   448,  90123,   7338,  97461
196551,13069, 0.0869589, 0.5158081, 0.1192477,  7837,  3785,  90123,   7338,  97461
196552,15084, 0.0000000, 0.0107991, 0.0023620,     0,    85,  28116,   7871,  35987
196552,13069, 0.0733442, 0.0953938, 0.0750044,  6610,   700,  90123,   7338,  97461
196553,15084, 0.0058330, 0.0907127, 0.0243977,   164,   714,  28116,   7871,  35987
196553,13069, 0.0000000, 0.0579177, 0.0043607,     0,   425,  90123,   7338,  97461
196554,15084, 0.0140134, 0.0010164, 0.0111707,   394,     8,  28116,   7871,  35987
196555,15084, 0.0994807, 0.0776267, 0.0947009,  2797,   611,  28116,   7871,  35987
196556,15016, 0.0000000, 0.0554092, 0.0230447,     0,   589,  14929,  10630,  25559
196556,15084, 0.0000000, 0.0002541, 0.0000556,     0,     2,  28116,   7871,  35987
196557,15016, 0.0000000, 0.0914393, 0.0380297,     0,   972,  14929,  10630,  25559
196558,15016, 0.1452207, 0.0297272, 0.0971869,  2168,   316,  14929,  10630,  25559
196560,15061, 0.0000000, 0.1052270, 0.0172007,     0,   153,   7441,   1454,   8895
196562,13072, 0.0000000, 0.0014652, 0.0003903,     0,     4,   7518,   2730,  10248
196562,13083, 0.0000000, 0.0194900, 0.0106022,     0,   415,  17850,  21293,  39143
196563,13072, 0.0163607, 0.0388278, 0.0223458,   123,   106,   7518,   2730,  10248
196564,13072, 0.0000000, 0.0025641, 0.0006831,     0,     7,   7518,   2730,  10248
196565,13072, 0.0000000, 0.0289377, 0.0077088,     0,    79,   7518,   2730,  10248
196566,13072, 0.0000000, 0.0003663, 0.0000976,     0,     1,   7518,   2730,  10248
196568,13061, 0.0000000, 0.0261953, 0.0039873,     0,   206,  43800,   7864,  51664
196569,13061, 0.0000000, 0.0503561, 0.0076649,     0,   396,  43800,   7864,  51664
196570,13061, 0.0000000, 0.0015259, 0.0002323,     0,    12,  43800,   7864,  51664
196571,13008, 0.0000000, 0.0190943, 0.0071424,     0,   304,  26642,  15921,  42563
196572,13008, 0.0000000, 0.0043967, 0.0016446,     0,    70,  26642,  15921,  42563
196573,13008, 0.0000000, 0.0092331, 0.0034537,     0,   147,  26642,  15921,  42563
196573,13016, 0.0000000, 0.0021034, 0.0010642,     0,    58,  26925,  27575,  54500
196574,13008, 0.0000000, 0.0108662, 0.0040646,     0,   173,  26642,  15921,  42563
196574,13007, 0.0000000, 0.0052372, 0.0030104,     0,    34,   4802,   6492,  11294
196575,13007, 0.0000000, 0.0021565, 0.0012396,     0,    14,   4802,   6492,  11294
196576,21053, 0.0000000, 0.0128574, 0.0078744,     0,   456,  22443,  35466,  57909
196577,21053, 0.0000000, 0.0087408, 0.0053532,     0,   310,  22443,  35466,  57909
196578,21053, 0.0000000, 0.0007049, 0.0004317,     0,    25,  22443,  35466,  57909
196579,21053, 0.0000000, 0.0051317, 0.0031429,     0,   182,  22443,  35466,  57909
196580,21053, 0.0000000, 0.0019455, 0.0011915,     0,    69,  22443,  35466,  57909
196581,21053, 0.0000000, 0.0013252, 0.0008116,     0,    47,  22443,  35466,  57909
196582,21053, 0.0002673, 0.0027068, 0.0017614,     6,    96,  22443,  35466,  57909
196583,21053, 0.6332932, 0.0075565, 0.2500648, 14213,   268,  22443,  35466,  57909
196584,21053, 0.1782293, 0.0211470, 0.0820252,  4000,   750,  22443,  35466,  57909
196585,21053, 0.0015595, 0.0047087, 0.0034882,    35,   167,  22443,  35466,  57909
196586,21016, 0.0000000, 0.0487980, 0.0431957,     0,   339,    901,   6947,   7848
196587,21208, 0.0000000, 0.0061542, 0.0029097,     0,   222,  40223,  36073,  76296
196589,21172, 0.0000000, 0.0943017, 0.0782771,     0,  2019,   4383,  21410,  25793
196590,21172, 0.0000000, 0.0237272, 0.0196953,     0,   508,   4383,  21410,  25793
196591,21172, 0.8286562, 0.1202709, 0.2406467,  3632,  2575,   4383,  21410,  25793
196592,21172, 0.0000000, 0.0666978, 0.0553639,     0,  1428,   4383,  21410,  25793
196593,21172, 0.0000000, 0.0164876, 0.0136859,     0,   353,   4383,  21410,  25793
196594,21172, 0.0000000, 0.0366651, 0.0304346,     0,   785,   4383,  21410,  25793
196595,21172, 0.0000000, 0.0130780, 0.0108557,     0,   280,   4383,  21410,  25793
196596,21200, 0.9183865, 0.1479789, 0.3579647,   979,   421,   1066,   2845,   3911
196597,21200, 0.0816135, 0.1606327, 0.1390949,    87,   457,   1066,   2845,   3911
196598,21207, 0.0816011, 0.0246830, 0.0530444,  2167,   660,  26556,  26739,  53295
197568,16017, 0.0000000, 0.0452207, 0.0394793,     0,  1301,   4184,  28770,  32954
197569,16017, 0.0000000, 0.0679527, 0.0593251,     0,  1955,   4184,  28770,  32954
197571,15085, 0.0000000, 0.0027593, 0.0015312,     0,    96,  27903,  34792,  62695
197574,15085, 0.0528975, 0.0146011, 0.0316453,  1476,   508,  27903,  34792,  62695
197575,15085, 0.0000000, 0.0027593, 0.0015312,     0,    96,  27903,  34792,  62695
197577,15001, 0.0000000, 0.0113508, 0.0097672,     0,   595,   8499,  52419,  60918
197577,15085, 0.0000000, 0.0159519, 0.0088524,     0,   555,  27903,  34792,  62695
197578,15014, 0.0000000, 0.0101350, 0.0048870,     0,   458,  48528,  45190,  93718
197579,15001, 0.0000000, 0.0471966, 0.0406120,     0,  2474,   8499,  52419,  60918
197581,15001, 0.0000000, 0.0017551, 0.0015102,     0,    92,   8499,  52419,  60918
197582,15102, 0.0000000, 0.1732464, 0.1622377,     0,  2497,    978,  14413,  15391
197583,15102, 0.2382413, 0.0925553, 0.1018127,   233,  1334,    978,  14413,  15391
197584,15102, 0.0000000, 0.0624436, 0.0584757,     0,   900,    978,  14413,  15391
197585,15102, 0.0000000, 0.0319850, 0.0299526,     0,   461,    978,  14413,  15391
197586,15026, 0.0148856, 0.0821668, 0.0509963,   190,  1215,  12764,  14787,  27551
197587,15026, 0.0019586, 0.0274565, 0.0156437,    25,   406,  12764,  14787,  27551
197588,15045, 0.0000000, 0.0030652, 0.0025073,     0,   210,  15245,  68510,  83755
197589,15045, 0.0000000, 0.0159977, 0.0130858,     0,  1096,  15245,  68510,  83755
197590,15026, 0.0000000, 0.0271860, 0.0145911,     0,   402,  12764,  14787,  27551
197594,13063, 0.0000000, 0.0002784, 0.0000868,     0,     7,  55465,  25147,  80612
197595,13063, 0.0000000, 0.0003181, 0.0000992,     0,     8,  55465,  25147,  80612
197596,13063, 0.0602362, 0.0218714, 0.0482682,  3341,   550,  55465,  25147,  80612
197597,13063, 0.0873524, 0.0004374, 0.0602392,  4845,    11,  55465,  25147,  80612
197598,13063, 0.0000000, 0.0002784, 0.0000868,     0,     7,  55465,  25147,  80612
197599,13063, 0.0000000, 0.0001591, 0.0000496,     0,     4,  55465,  25147,  80612
197600,13063, 0.0000000, 0.0938084, 0.0292636,     0,  2359,  55465,  25147,  80612
197600,13013, 0.0000000, 0.0932860, 0.0363923,     0,  1131,  18954,  12124,  31078
197601,15035, 0.0024398, 0.0119940, 0.0034592,   218,   128,  89351,  10672, 100023
197601,13013, 0.0000000, 0.0879248, 0.0343008,     0,  1066,  18954,  12124,  31078
197604,15096, 0.0882232, 0.5779643, 0.1570472,  2571,  2754,  29142,   4765,  33907
197606,15120, 0.0011543, 0.0220759, 0.0044786,   155,   560, 134280,  25367, 159647
197610,13069, 0.1811413, 0.0010902, 0.1675850, 16325,     8,  90123,   7338,  97461
197610,15036, 0.0000000, 0.1508285, 0.0310556,     0,  1238,  31656,   8208,  39864
197611,13069, 0.1600812, 0.2658763, 0.1680467, 14427,  1951,  90123,   7338,  97461
197611,13075, 0.0777422, 0.0126147, 0.0648624,   825,    33,  10612,   2616,  13228
197615,13066, 0.6721209, 0.0068531, 0.4638751,  5381,    25,   8006,   3648,  11654
197616,13066, 0.0000000, 0.1510417, 0.0472799,     0,   551,   8006,   3648,  11654
197616,15016, 0.0000000, 0.0687676, 0.0286005,     0,   731,  14929,  10630,  25559
197617,15016, 0.0152723, 0.0166510, 0.0158457,   228,   177,  14929,  10630,  25559
197617,13083, 0.0000000, 0.0000470, 0.0000255,     0,     1,  17850,  21293,  39143
197617,13066, 0.0000000, 0.0002741, 0.0000858,     0,     1,   8006,   3648,  11654
197618,15016, 0.0117891, 0.0191910, 0.0148676,   176,   204,  14929,  10630,  25559
197618,13083, 0.0000000, 0.0023012, 0.0012518,     0,    49,  17850,  21293,  39143
197619,13083, 0.0000000, 0.0565444, 0.0307590,     0,  1204,  17850,  21293,  39143
197620,13083, 0.0000000, 0.0207580, 0.0112919,     0,   442,  17850,  21293,  39143
197621,13083, 0.0000000, 0.0522707, 0.0284342,     0,  1113,  17850,  21293,  39143
197622,13083, 0.0000000, 0.0585169, 0.0318320,     0,  1246,  17850,  21293,  39143
197623,13083, 0.0000000, 0.0006105, 0.0003321,     0,    13,  17850,  21293,  39143
197624,13072, 0.0000000, 0.1238095, 0.0329820,     0,   338,   7518,   2730,  10248
197625,13072, 0.0000000, 0.0073260, 0.0019516,     0,    20,   7518,   2730,  10248
197628,13061, 0.0000000, 0.0592574, 0.0090198,     0,   466,  43800,   7864,  51664
197629,13061, 0.0000000, 0.0577314, 0.0087876,     0,   454,  43800,   7864,  51664
197631,13008, 0.0000000, 0.0005025, 0.0001880,     0,     8,  26642,  15921,  42563
197631,13016, 0.0000000, 0.0083409, 0.0042202,     0,   230,  26925,  27575,  54500
197632,13016, 0.0000000, 0.0106618, 0.0053945,     0,   294,  26925,  27575,  54500
197633,21053, 0.0000000, 0.0026222, 0.0016060,     0,    93,  22443,  35466,  57909
197635,21053, 0.0000000, 0.0680370, 0.0416688,     0,  2413,  22443,  35466,  57909
197636,21053, 0.0000000, 0.0024812, 0.0015196,     0,    88,  22443,  35466,  57909
197637,21053, 0.0000000, 0.0043986, 0.0026939,     0,   156,  22443,  35466,  57909
197638,21053, 0.0000000, 0.0088254, 0.0054050,     0,   313,  22443,  35466,  57909
197639,21053, 0.0000000, 0.0140980, 0.0086342,     0,   500,  22443,  35466,  57909
197641,21053, 0.0000000, 0.0003384, 0.0002072,     0,    12,  22443,  35466,  57909
197642,21053, 0.0675043, 0.0456494, 0.0541194,  1515,  1619,  22443,  35466,  57909
197643,21053, 0.1005213, 0.0072182, 0.0433784,  2256,   256,  22443,  35466,  57909
197644,21053, 0.0184913, 0.0032707, 0.0091696,   415,   116,  22443,  35466,  57909
197644,21208, 0.0000000, 0.0081501, 0.0038534,     0,   294,  40223,  36073,  76296
197646,21208, 0.0000000, 0.0136667, 0.0064617,     0,   493,  40223,  36073,  76296
197647,21172, 0.0000000, 0.0083139, 0.0069011,     0,   178,   4383,  21410,  25793
197647,21208, 0.0000000, 0.0013306, 0.0006291,     0,    48,  40223,  36073,  76296
197648,21172, 0.0000000, 0.0282578, 0.0234560,     0,   605,   4383,  21410,  25793
197649,21172, 0.0000000, 0.0143858, 0.0119412,     0,   308,   4383,  21410,  25793
197650,21172, 0.0000000, 0.0610462, 0.0506727,     0,  1307,   4383,  21410,  25793
197651,21172, 0.0000000, 0.0022887, 0.0018997,     0,    49,   4383,  21410,  25793
197652,21172, 0.0000000, 0.0475479, 0.0394681,     0,  1018,   4383,  21410,  25793
197653,21172, 0.0000000, 0.0597851, 0.0496259,     0,  1280,   4383,  21410,  25793
197654,21172, 0.0000000, 0.0259692, 0.0215562,     0,   556,   4383,  21410,  25793
197655,21200, 0.0000000, 0.0168717, 0.0122731,     0,    48,   1066,   2845,   3911
197655,21172, 0.0000000, 0.0011210, 0.0009305,     0,    24,   4383,  21410,  25793
197656,21200, 0.0000000, 0.1212654, 0.0882127,     0,   345,   1066,   2845,   3911
197657,21207, 0.0910529, 0.0454018, 0.0681490,  2418,  1214,  26556,  26739,  53295
198627,16017, 0.0000000, 0.0274592, 0.0239728,     0,   790,   4184,  28770,  32954
198628,16017, 0.0000000, 0.0020507, 0.0017904,     0,    59,   4184,  28770,  32954
198630,15085, 0.0000000, 0.0138825, 0.0077040,     0,   483,  27903,  34792,  62695
198631,15085, 0.0000000, 0.0316165, 0.0175453,     0,  1100,  27903,  34792,  62695
198632,15085, 0.0672329, 0.0222752, 0.0422841,  1876,   775,  27903,  34792,  62695
198633,15085, 0.2404401, 0.0193148, 0.1177287,  6709,   672,  27903,  34792,  62695
198634,15085, 0.0000000, 0.0602150, 0.0334157,     0,  2095,  27903,  34792,  62695
198636,15085, 0.0000000, 0.0398655, 0.0221230,     0,  1387,  27903,  34792,  62695
198636,15001, 0.1542534, 0.0267651, 0.0445517,  1311,  1403,   8499,  52419,  60918
198637,15001, 0.0000000, 0.0032622, 0.0028071,     0,   171,   8499,  52419,  60918
198638,15001, 0.0000000, 0.0432477, 0.0372140,     0,  2267,   8499,  52419,  60918
198639,15001, 0.0000000, 0.0108548, 0.0093404,     0,   569,   8499,  52419,  60918
198640,15001, 0.0000000, 0.0069059, 0.0059424,     0,   362,   8499,  52419,  60918
198641,15001, 0.0000000, 0.0214426, 0.0184510,     0,  1124,   8499,  52419,  60918
198642,15102, 0.0000000, 0.0049261, 0.0046131,     0,    71,    978,  14413,  15391
198644,15102, 0.0000000, 0.0905433, 0.0847898,     0,  1305,    978,  14413,  15391
198644,15045, 0.0000000, 0.0007152, 0.0005850,     0,    49,  15245,  68510,  83755
198646,15045, 0.0000000, 0.0365348, 0.0298848,     0,  2503,  15245,  68510,  83755
198647,15045, 0.0000000, 0.0140855, 0.0115217,     0,   965,  15245,  68510,  83755
198648,15045, 0.0000000, 0.0407678, 0.0333473,     0,  2793,  15245,  68510,  83755
198649,15045, 0.0000000, 0.0180704, 0.0147812,     0,  1238,  15245,  68510,  83755
198652,13063, 0.0000000, 0.0005567, 0.0001737,     0,    14,  55465,  25147,  80612
198654,13063, 0.0000000, 0.0007158, 0.0002233,     0,    18,  55465,  25147,  80612
198655,13063, 0.1766159, 0.0012725, 0.1219173,  9796,    32,  55465,  25147,  80612
198656,13063, 0.3926080, 0.0351931, 0.2811120, 21776,   885,  55465,  25147,  80612
198657,13063, 0.0163346, 0.0004374, 0.0113755,   906,    11,  55465,  25147,  80612
198658,13063, 0.0000000, 0.0010339, 0.0003225,     0,    26,  55465,  25147,  80612
198664,15096, 0.0027452, 0.0467996, 0.0089362,    80,   223,  29142,   4765,  33907
198667,15036, 0.0000000, 0.2688840, 0.0553632,     0,  2207,  31656,   8208,  39864
198670,13075, 0.2780814, 0.0107034, 0.2252041,  2951,    28,  10612,   2616,  13228
198671,13075, 0.0000000, 0.1693425, 0.0334896,     0,   443,  10612,   2616,  13228
198672,15084, 0.0000000, 0.1295896, 0.0283436,     0,  1020,  28116,   7871,  35987
198674,13066, 0.2957782, 0.3519737, 0.3133688,  2368,  1284,   8006,   3648,  11654
198675,13066, 0.0000000, 0.0084978, 0.0026600,     0,    31,   8006,   3648,  11654
198678,13083, 0.0208403, 0.0000470, 0.0095292,   372,     1,  17850,  21293,  39143
198679,13083, 0.1175350, 0.0050251, 0.0563319,  2098,   107,  17850,  21293,  39143
198680,13083, 0.0263305, 0.0000470, 0.0120328,   470,     1,  17850,  21293,  39143
198681,13083, 0.0000000, 0.0151223, 0.0082262,     0,   322,  17850,  21293,  39143
198682,13083, 0.0000000, 0.0010332, 0.0005620,     0,    22,  17850,  21293,  39143
198683,13083, 0.0000000, 0.1344573, 0.0731421,     0,  2863,  17850,  21293,  39143
198686,13057, 0.0000000, 0.0310905, 0.0225574,     0,   335,   4076,  10775,  14851
198687,13061, 0.0000000, 0.0144964, 0.0022066,     0,   114,  43800,   7864,  51664
198687,13057, 0.0000000, 0.0035267, 0.0025588,     0,    38,   4076,  10775,  14851
198689,13061, 0.0000000, 0.0574771, 0.0087488,     0,   452,  43800,   7864,  51664
198689,13016, 0.0000000, 0.0006165, 0.0003119,     0,    17,  26925,  27575,  54500
198690,13016, 0.0000000, 0.0223391, 0.0113028,     0,   616,  26925,  27575,  54500
198691,13016, 0.0000000, 0.0129465, 0.0065505,     0,   357,  26925,  27575,  54500
198692,13016, 0.0000000, 0.0143971, 0.0072844,     0,   397,  26925,  27575,  54500
198693,21053, 0.0000000, 0.0259403, 0.0158870,     0,   920,  22443,  35466,  57909
198695,21053, 0.0000000, 0.0010151, 0.0006217,     0,    36,  22443,  35466,  57909
198697,21053, 0.0000000, 0.0019455, 0.0011915,     0,    69,  22443,  35466,  57909
198698,21053, 0.0000000, 0.0318051, 0.0194788,     0,  1128,  22443,  35466,  57909
198699,21053, 0.0000000, 0.0018327, 0.0011225,     0,    65,  22443,  35466,  57909
198700,21053, 0.0000000, 0.0066543, 0.0040754,     0,   236,  22443,  35466,  57909
198701,21053, 0.0000000, 0.0034681, 0.0021240,     0,   123,  22443,  35466,  57909
198702,21208, 0.0000000, 0.0241732, 0.0114292,     0,   872,  40223,  36073,  76296
198703,21208, 0.0000000, 0.0836360, 0.0395434,     0,  3017,  40223,  36073,  76296
198704,21208, 0.0000000, 0.0018851, 0.0008913,     0,    68,  40223,  36073,  76296
198705,21208, 0.0000000, 0.0050730, 0.0023986,     0,   183,  40223,  36073,  76296
198706,21208, 0.0000000, 0.0162171, 0.0076675,     0,   585,  40223,  36073,  76296
198707,21208, 0.0000000, 0.0143598, 0.0067893,     0,   518,  40223,  36073,  76296
198708,21172, 0.0000000, 0.0360112, 0.0298918,     0,   771,   4383,  21410,  25793
198709,21039, 0.0000000, 0.1584134, 0.1396005,     0,  1286,   1094,   8118,   9212
198710,21039, 0.0000000, 0.0057896, 0.0051020,     0,    47,   1094,   8118,   9212
198710,21172, 0.0000000, 0.0025222, 0.0020936,     0,    54,   4383,  21410,  25793
198711,21172, 0.0000000, 0.0635217, 0.0527275,     0,  1360,   4383,  21410,  25793
198712,21172, 0.0000000, 0.0104157, 0.0086458,     0,   223,   4383,  21410,  25793
198713,21172, 0.0000000, 0.0106025, 0.0088008,     0,   227,   4383,  21410,  25793
198714,21172, 0.0000000, 0.0071462, 0.0059318,     0,   153,   4383,  21410,  25793
198714,21200, 0.0000000, 0.1666081, 0.1211966,     0,   474,   1066,   2845,   3911
198715,21200, 0.0000000, 0.2260105, 0.1644081,     0,   643,   1066,   2845,   3911
198716,21207, 0.0457147, 0.1479861, 0.0970260,  1214,  3957,  26556,  26739,  53295
199686,16017, 1.0000000, 0.0135210, 0.1387692,  4184,   389,   4184,  28770,  32954
199688,15085, 0.0000000, 0.0037940, 0.0021054,     0,   132,  27903,  34792,  62695
199689,15085, 0.0000000, 0.0436595, 0.0242284,     0,  1519,  27903,  34792,  62695
199690,15085, 0.0000000, 0.0075880, 0.0042109,     0,   264,  27903,  34792,  62695
199692,15085, 0.1722037, 0.0671994, 0.1139325,  4805,  2338,  27903,  34792,  62695
199693,15001, 0.0000000, 0.0194586, 0.0167438,     0,  1020,   8499,  52419,  60918
199694,15001, 0.0141193, 0.0184284, 0.0178272,   120,   966,   8499,  52419,  60918
199696,15001, 0.0021179, 0.0021939, 0.0021833,    18,   115,   8499,  52419,  60918
199697,15001, 0.4712319, 0.0690017, 0.1251190,  4005,  3617,   8499,  52419,  60918
199698,15001, 0.0002353, 0.0033766, 0.0029384,     2,   177,   8499,  52419,  60918
199699,15001, 0.0000000, 0.0103398, 0.0088972,     0,   542,   8499,  52419,  60918
199700,15001, 0.0000000, 0.0252580, 0.0217341,     0,  1324,   8499,  52419,  60918
199702,15045, 0.0000000, 0.0130638, 0.0106859,     0,   895,  15245,  68510,  83755
199704,15045, 0.0000000, 0.0100861, 0.0082503,     0,   691,  15245,  68510,  83755
199705,15045, 0.0000000, 0.0079988, 0.0065429,     0,   548,  15245,  68510,  83755
199706,15045, 0.0000000, 0.0388119, 0.0317474,     0,  2659,  15245,  68510,  83755
199707,15045, 0.0099705, 0.0533645, 0.0454659,   152,  3656,  15245,  68510,  83755
199708,15045, 0.5683831, 0.0441833, 0.1395976,  8665,  3027,  15245,  68510,  83755
199709,15045, 0.0005904, 0.0264341, 0.0217300,     9,  1811,  15245,  68510,  83755
199710,15045, 0.0000000, 0.0104510, 0.0085487,     0,   716,  15245,  68510,  83755
199712,13063, 0.0000000, 0.0001591, 0.0000496,     0,     4,  55465,  25147,  80612
199713,13063, 0.0000000, 0.0595697, 0.0185828,     0,  1498,  55465,  25147,  80612
199715,13063, 0.0171820, 0.0250925, 0.0196497,   953,   631,  55465,  25147,  80612
199715,13076, 0.0000000, 0.0058890, 0.0017032,     0,   177,  73863,  30056, 103919
199716,13063, 0.0021635, 0.0237802, 0.0089069,   120,   598,  55465,  25147,  80612
199716,13076, 0.0000000, 0.0054232, 0.0015685,     0,   163,  73863,  30056, 103919
199716,13013, 0.0000000, 0.0106401, 0.0041508,     0,   129,  18954,  12124,  31078
199718,13013, 0.0000000, 0.0724183, 0.0282515,     0,   878,  18954,  12124,  31078
199720,15010, 0.0559063, 0.0974039, 0.0708913,   983,   968,  17583,   9938,  27521
199721,15010, 0.0000000, 0.0301872, 0.0109008,     0,   300,  17583,   9938,  27521
199722,15096, 0.0050443, 0.0434418, 0.0104403,   147,   207,  29142,   4765,  33907
199722,15010, 0.0000000, 0.0002012, 0.0000727,     0,     2,  17583,   9938,  27521
199723,15096, 0.2218448, 0.0690451, 0.2003716,  6465,   329,  29142,   4765,  33907
199725,15036, 0.0000000, 0.0519006, 0.0106863,     0,   426,  31656,   8208,  39864
199727,15036, 0.2217589, 0.0119396, 0.1785571,  7020,    98,  31656,   8208,  39864
199728,13075, 0.0000000, 0.0019113, 0.0003780,     0,     5,  10612,   2616,  13228
199731,13082, 0.0000000, 0.0342466, 0.0002772,     0,     5,  17890,    146,  18036
199734,13066, 0.0000000, 0.0816886, 0.0255706,     0,   298,   8006,   3648,  11654
199735,13066, 0.0000000, 0.3637610, 0.1138665,     0,  1327,   8006,   3648,  11654
199737,13083, 0.0236975, 0.0003287, 0.0109854,   423,     7,  17850,  21293,  39143
199738,13083, 0.1820168, 0.0340487, 0.1015252,  3249,   725,  17850,  21293,  39143
199739,13083, 0.0104762, 0.0000470, 0.0048029,   187,     1,  17850,  21293,  39143
199740,13083, 0.0000000, 0.0022543, 0.0012263,     0,    48,  17850,  21293,  39143
199741,13083, 0.0000000, 0.0603485, 0.0328283,     0,  1285,  17850,  21293,  39143
199742,13083, 0.0000000, 0.0002818, 0.0001533,     0,     6,  17850,  21293,  39143
199742,13057, 0.0000000, 0.0056613, 0.0041075,     0,    61,   4076,  10775,  14851
199743,13057, 0.0000000, 0.0004640, 0.0003367,     0,     5,   4076,  10775,  14851
199744,13057, 0.0000000, 0.0322042, 0.0233654,     0,   347,   4076,  10775,  14851
199745,13057, 0.0000000, 0.0056613, 0.0041075,     0,    61,   4076,  10775,  14851
199746,13057, 0.0000000, 0.0022274, 0.0016161,     0,    24,   4076,  10775,  14851
199748,13057, 0.0000000, 0.0497448, 0.0360918,     0,   536,   4076,  10775,  14851
199748,13016, 0.0000000, 0.0008704, 0.0004404,     0,    24,  26925,  27575,  54500
199749,13016, 0.0000000, 0.0133454, 0.0067523,     0,   368,  26925,  27575,  54500
199750,13016, 0.0000000, 0.0242611, 0.0122752,     0,   669,  26925,  27575,  54500
199751,13016, 0.0000000, 0.0158477, 0.0080183,     0,   437,  26925,  27575,  54500
199752,13016, 0.0000000, 0.0000363, 0.0000183,     0,     1,  26925,  27575,  54500
199754,21053, 0.0000000, 0.0070490, 0.0043171,     0,   250,  22443,  35466,  57909
199755,21053, 0.0000000, 0.0315513, 0.0193234,     0,  1119,  22443,  35466,  57909
199756,21053, 0.0000000, 0.0153950, 0.0094286,     0,   546,  22443,  35466,  57909
199757,21053, 0.0000000, 0.0130830, 0.0080126,     0,   464,  22443,  35466,  57909
199758,21053, 0.0000000, 0.0014098, 0.0008634,     0,    50,  22443,  35466,  57909
199759,21053, 0.0000000, 0.0068798, 0.0042135,     0,   244,  22443,  35466,  57909
199759,21208, 0.0000000, 0.0000832, 0.0000393,     0,     3,  40223,  36073,  76296
199760,21208, 0.0000000, 0.0151360, 0.0071563,     0,   546,  40223,  36073,  76296
199761,21208, 0.0000000, 0.0217337, 0.0102758,     0,   784,  40223,  36073,  76296
199762,21208, 0.0167566, 0.0501483, 0.0325443,   674,  1809,  40223,  36073,  76296
199763,21208, 0.0206350, 0.0454079, 0.0323477,   830,  1638,  40223,  36073,  76296
199765,21208, 0.0000000, 0.0277493, 0.0131200,     0,  1001,  40223,  36073,  76296
199766,21167, 0.0000000, 0.0345094, 0.0305664,     0,   313,   1170,   9070,  10240
199767,21172, 0.0000000, 0.0212985, 0.0176792,     0,   456,   4383,  21410,  25793
199768,21039, 0.5923218, 0.1938901, 0.2412071,   648,  1574,   1094,   8118,   9212
199769,21039, 0.3638026, 0.2262873, 0.2426183,   398,  1837,   1094,   8118,   9212
199771,21078, 0.0000000, 0.1179069, 0.0878272,     0,  1228,   3567,  10415,  13982
199772,21078, 0.0000000, 0.0171867, 0.0128022,     0,   179,   3567,  10415,  13982
199773,21172, 0.0000000, 0.0070061, 0.0058155,     0,   150,   4383,  21410,  25793
199774,21172, 0.0000000, 0.0053713, 0.0044586,     0,   115,   4383,  21410,  25793
199775,21207, 0.0666516, 0.0173529, 0.0419176,  1770,   464,  26556,  26739,  53295
199775,21200, 0.0000000, 0.1216169, 0.0884684,     0,   346,   1066,   2845,   3911
200745,16017, 0.0000000, 0.0334724, 0.0292226,     0,   963,   4184,  28770,  32954
200747,15085, 0.0000000, 0.0064957, 0.0036048,     0,   226,  27903,  34792,  62695
200748,15085, 0.0000000, 0.0295758, 0.0164128,     0,  1029,  27903,  34792,  62695
200749,15085, 0.0000000, 0.0534318, 0.0296515,     0,  1859,  27903,  34792,  62695
200750,15085, 0.0000000, 0.0870890, 0.0483292,     0,  3030,  27903,  34792,  62695
200751,15085, 0.0000000, 0.0003449, 0.0001914,     0,    12,  27903,  34792,  62695
200751,15001, 0.0000000, 0.0050173, 0.0043173,     0,   263,   8499,  52419,  60918
200752,15001, 0.0000000, 0.0393178, 0.0338324,     0,  2061,   8499,  52419,  60918
200753,15001, 0.0000000, 0.0435911, 0.0375094,     0,  2285,   8499,  52419,  60918
200754,15001, 0.0000000, 0.0262691, 0.0226042,     0,  1377,   8499,  52419,  60918
200755,15001, 0.0000000, 0.0871058, 0.0749532,     0,  4566,   8499,  52419,  60918
200756,15001, 0.0082363, 0.0207749, 0.0190256,    70,  1089,   8499,  52419,  60918
200758,15001, 0.0000000, 0.0099391, 0.0085525,     0,   521,   8499,  52419,  60918
200759,15001, 0.0000000, 0.0093478, 0.0080436,     0,   490,   8499,  52419,  60918
200760,15001, 0.0000000, 0.0143269, 0.0123280,     0,   751,   8499,  52419,  60918
200762,15102, 0.0000000, 0.0350378, 0.0328114,     0,   505,    978,  14413,  15391
200764,15045, 0.1019351, 0.0100277, 0.0267566,  1554,   687,  15245,  68510,  83755
200765,15045, 0.0789767, 0.0630419, 0.0659423,  1204,  4319,  15245,  68510,  83755
200766,15045, 0.0026238, 0.0610276, 0.0503970,    40,  4181,  15245,  68510,  83755
200767,15045, 0.1942276, 0.0507809, 0.0768909,  2961,  3479,  15245,  68510,  83755
200768,15045, 0.0000000, 0.0542549, 0.0443794,     0,  3717,  15245,  68510,  83755
200769,15045, 0.0000000, 0.0246971, 0.0202018,     0,  1692,  15245,  68510,  83755
200770,13063, 0.0000000, 0.0990575, 0.0309011,     0,  2491,  55465,  25147,  80612
200771,13063, 0.0000000, 0.0037778, 0.0011785,     0,    95,  55465,  25147,  80612
200772,13063, 0.0000000, 0.0779417, 0.0243140,     0,  1960,  55465,  25147,  80612
200773,13063, 0.0000000, 0.1762437, 0.0549794,     0,  4432,  55465,  25147,  80612
200773,13076, 0.0000000, 0.0263175, 0.0076117,     0,   791,  73863,  30056, 103919
200774,13063, 0.0000000, 0.0002386, 0.0000744,     0,     6,  55465,  25147,  80612
200774,13076, 0.0060517, 0.0011645, 0.0046382,   447,    35,  73863,  30056, 103919
200775,13076, 0.0000000, 0.0001664, 0.0000481,     0,     5,  73863,  30056, 103919
200775,13013, 0.0000000, 0.0567469, 0.0221378,     0,   688,  18954,  12124,  31078
200776,13013, 0.0071225, 0.0754701, 0.0337860,   135,   915,  18954,  12124,  31078
200778,13013, 0.0000000, 0.0389310, 0.0151876,     0,   472,  18954,  12124,  31078
200779,15010, 0.2996076, 0.0542363, 0.2110025,  5268,   539,  17583,   9938,  27521
200780,15010, 0.4288802, 0.0238479, 0.2826205,  7541,   237,  17583,   9938,  27521
200783,15036, 0.0120040, 0.0053606, 0.0106362,   380,    44,  31656,   8208,  39864
200784,15036, 0.0974539, 0.0031676, 0.0780403,  3085,    26,  31656,   8208,  39864
200788,13075, 0.4925556, 0.0217890, 0.3994557,  5227,    57,  10612,   2616,  13228
200789,13075, 0.1516208, 0.4243119, 0.2055488,  1609,  1110,  10612,   2616,  13228
200789,13082, 0.0000000, 0.1438356, 0.0011643,     0,    21,  17890,    146,  18036
200791,13082, 0.0107882, 0.0342466, 0.0109780,   193,     5,  17890,    146,  18036
200793,13066, 0.0000000, 0.0359101, 0.0112408,     0,   131,   8006,   3648,  11654
200793,13083, 0.0085154, 0.0055417, 0.0068978,   152,   118,  17850,  21293,  39143
200794,13083, 0.0000000, 0.1131358, 0.0615436,     0,  2409,  17850,  21293,  39143
200796,13083, 0.0000000, 0.0526934, 0.0286641,     0,  1122,  17850,  21293,  39143
200797,13083, 0.0000000, 0.0308082, 0.0167591,     0,   656,  17850,  21293,  39143
200798,13083, 0.0000000, 0.0000470, 0.0000255,     0,     1,  17850,  21293,  39143
200798,13022, 0.0000000, 0.0196023, 0.0151121,     0,   209,   3168,  10662,  13830
200799,13083, 0.0000000, 0.0064810, 0.0035255,     0,   138,  17850,  21293,  39143
200800,13083, 0.0000000, 0.0329686, 0.0179342,     0,   702,  17850,  21293,  39143
200800,13057, 0.0000000, 0.0007425, 0.0005387,     0,     8,   4076,  10775,  14851
200801,13057, 0.0000000, 0.0159629, 0.0115817,     0,   172,   4076,  10775,  14851
200802,13057, 0.1987242, 0.0265429, 0.0737997,   810,   286,   4076,  10775,  14851
200803,13057, 0.0051521, 0.0262645, 0.0204700,    21,   283,   4076,  10775,  14851
200804,13057, 0.0000000, 0.0096520, 0.0070029,     0,   104,   4076,  10775,  14851
200805,13057, 0.0000000, 0.0077958, 0.0056562,     0,    84,   4076,  10775,  14851
200806,13057, 0.0000000, 0.0037123, 0.0026934,     0,    40,   4076,  10775,  14851
200807,13016, 0.0000000, 0.0008341, 0.0004220,     0,    23,  26925,  27575,  54500
200807,13057, 0.0000000, 0.0334107, 0.0242408,     0,   360,   4076,  10775,  14851
200808,13016, 0.0000000, 0.0017044, 0.0008624,     0,    47,  26925,  27575,  54500
200809,13016, 0.0000000, 0.0260018, 0.0131560,     0,   717,  26925,  27575,  54500
200810,13016, 0.0000000, 0.0101904, 0.0051560,     0,   281,  26925,  27575,  54500
200812,13016, 0.0000000, 0.0021034, 0.0010642,     0,    58,  26925,  27575,  54500
200813,21053, 0.0000000, 0.0499633, 0.0305997,     0,  1772,  22443,  35466,  57909
200814,21053, 0.0000000, 0.0001410, 0.0000863,     0,     5,  22443,  35466,  57909
200815,21053, 0.0000000, 0.0117859, 0.0072182,     0,   418,  22443,  35466,  57909
200817,21053, 0.0000000, 0.0128856, 0.0078917,     0,   457,  22443,  35466,  57909
200818,21208, 0.0000000, 0.0018851, 0.0008913,     0,    68,  40223,  36073,  76296
200819,21208, 0.0000000, 0.0163280, 0.0077199,     0,   589,  40223,  36073,  76296
200820,21208, 0.0000000, 0.0004990, 0.0002359,     0,    18,  40223,  36073,  76296
200821,21208, 0.2390175, 0.0392537, 0.1445685,  9614,  1416,  40223,  36073,  76296
200822,21208, 0.4492952, 0.0015524, 0.2376009, 18072,    56,  40223,  36073,  76296
200823,21208, 0.0000000, 0.0606825, 0.0286909,     0,  2189,  40223,  36073,  76296
200824,21167, 0.0000000, 0.1254686, 0.1111328,     0,  1138,   1170,   9070,  10240
200825,21167, 0.0000000, 0.1911797, 0.1693359,     0,  1734,   1170,   9070,  10240
200826,21167, 0.0000000, 0.0263506, 0.0233398,     0,   239,   1170,   9070,  10240
200827,21039, 0.0402194, 0.1694999, 0.1541468,    44,  1376,   1094,   8118,   9212
200828,21039, 0.0036563, 0.0952205, 0.0843465,     4,   773,   1094,   8118,   9212
200830,21078, 0.0000000, 0.0939030, 0.0699471,     0,   978,   3567,  10415,  13982
200831,21078, 0.0000000, 0.1677388, 0.1249464,     0,  1747,   3567,  10415,  13982
200832,21202, 0.0000000, 0.1398451, 0.0795983,     0,   975,   5277,   6972,  12249
200833,21202, 0.0452909, 0.4691624, 0.2865540,   239,  3271,   5277,   6972,  12249
200834,21207, 0.0094141, 0.0007106, 0.0050474,   250,    19,  26556,  26739,  53295
200834,21101, 0.0000000, 0.2343358, 0.1559200,     0,   561,   1204,   2394,   3598
201804,16017, 0.0000000, 0.0092457, 0.0080719,     0,   266,   4184,  28770,  32954
201807,15085, 0.0000000, 0.0540642, 0.0300024,     0,  1881,  27903,  34792,  62695
201808,15085, 0.0000000, 0.0344045, 0.0190924,     0,  1197,  27903,  34792,  62695
201808,15001, 0.0000000, 0.0169404, 0.0145770,     0,   888,   8499,  52419,  60918
201809,15001, 0.0000000, 0.0138499, 0.0119177,     0,   726,   8499,  52419,  60918
201811,15001, 0.0000000, 0.0196112, 0.0168751,     0,  1028,   8499,  52419,  60918
201812,15001, 0.0000000, 0.0022892, 0.0019699,     0,   120,   8499,  52419,  60918
201813,15001, 0.0000000, 0.0272230, 0.0234249,     0,  1427,   8499,  52419,  60918
201814,15001, 0.0000000, 0.0050554, 0.0043501,     0,   265,   8499,  52419,  60918
201815,15001, 0.0000000, 0.0464145, 0.0399389,     0,  2433,   8499,  52419,  60918
201816,15001, 0.0000000, 0.0238463, 0.0205194,     0,  1250,   8499,  52419,  60918
201817,15001, 0.0000000, 0.0103779, 0.0089300,     0,   544,   8499,  52419,  60918
201818,15001, 0.0000000, 0.0063336, 0.0054499,     0,   332,   8499,  52419,  60918
201819,15001, 0.0000000, 0.0330415, 0.0284317,     0,  1732,   8499,  52419,  60918
201821,15045, 0.0000000, 0.0292658, 0.0239389,     0,  2005,  15245,  68510,  83755
201822,15045, 0.0000000, 0.0045395, 0.0037132,     0,   311,  15245,  68510,  83755
201823,15045, 0.0396851, 0.0104948, 0.0158080,   605,   719,  15245,  68510,  83755
201824,15045, 0.0035421, 0.0313969, 0.0263268,    54,  2151,  15245,  68510,  83755
201828,15079, 0.0000000, 0.0962588, 0.0612816,     0,   723,   4287,   7511,  11798
201829,15079, 0.0000000, 0.0700306, 0.0445838,     0,   526,   4287,   7511,  11798
201829,13063, 0.0000000, 0.0032608, 0.0010172,     0,    82,  55465,  25147,  80612
201831,13063, 0.0310827, 0.0004374, 0.0215228,  1724,    11,  55465,  25147,  80612
201832,13076, 0.0046302, 0.0726311, 0.0242978,   342,  2183,  73863,  30056, 103919
201833,13076, 0.1192613, 0.0506721, 0.0994236,  8809,  1523,  73863,  30056, 103919
201834,13076, 0.0252494, 0.0112124, 0.0211896,  1865,   337,  73863,  30056, 103919
201835,13013, 0.0000000, 0.0334048, 0.0130317,     0,   405,  18954,  12124,  31078
201835,13076, 0.0046167, 0.0048909, 0.0046960,   341,   147,  73863,  30056, 103919
201836,13013, 0.0564525, 0.2005114, 0.1126520,  1070,  2431,  18954,  12124,  31078
201837,13013, 0.2480743, 0.0020620, 0.1521012,  4702,    25,  18954,  12124,  31078
201838,15010, 0.0903145, 0.0342121, 0.0700556,  1588,   340,  17583,   9938,  27521
201838,13013, 0.1479371, 0.1509403, 0.1491087,  2804,  1830,  18954,  12124,  31078
201839,15010, 0.1253483, 0.5743610, 0.2874896,  2204,  5708,  17583,   9938,  27521
201840,15010, 0.0000000, 0.1855504, 0.0670034,     0,  1844,  17583,   9938,  27521
201842,13052, 0.0000000, 0.0457451, 0.0270144,     0,   866,  13126,  18931,  32057
201843,13052, 0.0000000, 0.0530347, 0.0313192,     0,  1004,  13126,  18931,  32057
201844,13052, 0.0000000, 0.0008980, 0.0005303,     0,    17,  13126,  18931,  32057
201844,15036, 0.0000000, 0.0932018, 0.0191902,     0,   765,  31656,   8208,  39864
201847,13075, 0.0000000, 0.3543578, 0.0700786,     0,   927,  10612,   2616,  13228
201849,13082, 0.4124092, 0.6301370, 0.4141717,  7378,    92,  17890,    146,  18036
201850,13082, 0.0149245, 0.0205479, 0.0149701,   267,     3,  17890,    146,  18036
201851,13082, 0.0000000, 0.0273973, 0.0002218,     0,     4,  17890,    146,  18036
201853,13083, 0.0000000, 0.0000470, 0.0000255,     0,     1,  17850,  21293,  39143
201854,13083, 0.0000000, 0.0341427, 0.0185729,     0,   727,  17850,  21293,  39143
201855,13083, 0.0000000, 0.0197718, 0.0107554,     0,   421,  17850,  21293,  39143
201855,13022, 0.0000000, 0.0926655, 0.0714389,     0,   988,   3168,  10662,  13830
201856,13022, 0.0000000, 0.0118177, 0.0091106,     0,   126,   3168,  10662,  13830
201857,13022, 0.0000000, 0.0012193, 0.0009400,     0,    13,   3168,  10662,  13830
201858,13083, 0.0000000, 0.0004227, 0.0002299,     0,     9,  17850,  21293,  39143
201858,13022, 0.0000000, 0.2034328, 0.1568330,     0,  2169,   3168,  10662,  13830
201859,13083, 0.0000000, 0.0091579, 0.0049817,     0,   195,  17850,  21293,  39143
201859,13057, 0.0000000, 0.0190255, 0.0138038,     0,   205,   4076,  10775,  14851
201859,13022, 0.0000000, 0.0004690, 0.0003615,     0,     5,   3168,  10662,  13830
201860,13057, 0.0000000, 0.0268213, 0.0194600,     0,   289,   4076,  10775,  14851
201861,13057, 0.7755152, 0.0387935, 0.2409939,  3161,   418,   4076,  10775,  14851
201862,13057, 0.0206084, 0.0474246, 0.0400646,    84,   511,   4076,  10775,  14851
201863,13057, 0.0000000, 0.0344316, 0.0249815,     0,   371,   4076,  10775,  14851
201864,13057, 0.0000000, 0.0015777, 0.0011447,     0,    17,   4076,  10775,  14851
201868,13016, 0.0000000, 0.0072892, 0.0036881,     0,   201,  26925,  27575,  54500
201869,13016, 0.0000000, 0.0096827, 0.0048991,     0,   267,  26925,  27575,  54500
201870,13016, 0.0000743, 0.0308250, 0.0156330,     2,   850,  26925,  27575,  54500
201871,13016, 0.0047168, 0.0014143, 0.0030459,   127,    39,  26925,  27575,  54500
201872,13016, 0.0000000, 0.0049683, 0.0025138,     0,   137,  26925,  27575,  54500
201873,21053, 0.0000000, 0.0037501, 0.0022967,     0,   133,  22443,  35466,  57909
201873,13016, 0.0000000, 0.0098277, 0.0049725,     0,   271,  26925,  27575,  54500
201874,21208, 0.0000000, 0.0061819, 0.0029228,     0,   223,  40223,  36073,  76296
201874,21053, 0.0000000, 0.0013534, 0.0008289,     0,    48,  22443,  35466,  57909
201875,21053, 0.0000000, 0.0149439, 0.0091523,     0,   530,  22443,  35466,  57909
201875,21208, 0.0000000, 0.0071799, 0.0033947,     0,   259,  40223,  36073,  76296
201876,21208, 0.0000000, 0.0087046, 0.0041155,     0,   314,  40223,  36073,  76296
201877,21208, 0.0000000, 0.0245613, 0.0116127,     0,   886,  40223,  36073,  76296
201878,21208, 0.0000000, 0.0021068, 0.0009961,     0,    76,  40223,  36073,  76296
201880,21208, 0.0892524, 0.0314363, 0.0619167,  3590,  1134,  40223,  36073,  76296
201881,21208, 0.1331079, 0.0115599, 0.0756396,  5354,   417,  40223,  36073,  76296
201883,21167, 0.0000000, 0.0776185, 0.0687500,     0,   704,   1170,   9070,  10240
201885,21167, 1.0000000, 0.1724366, 0.2669922,  1170,  1564,   1170,   9070,  10240
201886,21167, 0.0000000, 0.2298787, 0.2036133,     0,  2085,   1170,   9070,  10240
201887,21039, 0.0000000, 0.1508992, 0.1329787,     0,  1225,   1094,   8118,   9212
201889,21078, 0.0000000, 0.0723956, 0.0539265,     0,   754,   3567,  10415,  13982
201890,21078, 0.5393888, 0.1065771, 0.2169933,  1924,  1110,   3567,  10415,  13982
201891,21202, 0.0000000, 0.1018359, 0.0579639,     0,   710,   5277,   6972,  12249
201892,21202, 0.2649232, 0.0593804, 0.1479304,  1398,   414,   5277,   6972,  12249
201893,21101, 1.0000000, 0.1127820, 0.4096720,  1204,   270,   1204,   2394,   3598
202863,16017, 0.0000000, 0.0020855, 0.0018207,     0,    60,   4184,  28770,  32954
202864,15085, 0.0000000, 0.0244022, 0.0135417,     0,   849,  27903,  34792,  62695
202864,22001, 0.0000000, 0.0005688, 0.0004984,     0,    31,   7698,  54499,  62197
202865,15085, 0.0000000, 0.0192573, 0.0106867,     0,   670,  27903,  34792,  62695
202865,22001, 0.0000000, 0.0238720, 0.0209174,     0,  1301,   7698,  54499,  62197
202866,22001, 0.0000000, 0.0250096, 0.0219142,     0,  1363,   7698,  54499,  62197
202867,15001, 0.0000000, 0.0029569, 0.0025444,     0,   155,   8499,  52419,  60918
202868,15001, 0.0000000, 0.0277762, 0.0239010,     0,  1456,   8499,  52419,  60918
202869,15001, 0.0000000, 0.0463000, 0.0398404,     0,  2427,   8499,  52419,  60918
202870,15001, 0.0000000, 0.0439917, 0.0378542,     0,  2306,   8499,  52419,  60918
202871,15001, 0.0000000, 0.0047502, 0.0040875,     0,   249,   8499,  52419,  60918
202873,15003, 0.0000000, 0.0360184, 0.0315240,     0,  1413,   5593,  39230,  44823
202874,15003, 0.0000000, 0.0290339, 0.0254111,     0,  1139,   5593,  39230,  44823
202875,15001, 0.0000000, 0.0002098, 0.0001806,     0,    11,   8499,  52419,  60918
202876,15001, 0.0000000, 0.0052843, 0.0045471,     0,   277,   8499,  52419,  60918
202878,15003, 0.0000000, 0.0419067, 0.0366776,     0,  1644,   5593,  39230,  44823
202880,15045, 0.0000000, 0.0111663, 0.0091338,     0,   765,  15245,  68510,  83755
202881,15045, 0.0000000, 0.0175303, 0.0143394,     0,  1201,  15245,  68510,  83755
202882,15045, 0.0000000, 0.0118377, 0.0096830,     0,   811,  15245,  68510,  83755
202883,15045, 0.0000000, 0.0377901, 0.0309116,     0,  2589,  15245,  68510,  83755
202888,15079, 0.0000000, 0.1409932, 0.0897610,     0,  1059,   4287,   7511,  11798
202891,13076, 0.0295818, 0.0108797, 0.0241727,  2185,   327,  73863,  30056, 103919
202892,13076, 0.1047751, 0.1520162, 0.1184384,  7739,  4569,  73863,  30056, 103919
202894,13076, 0.0436890, 0.0077522, 0.0332952,  3227,   233,  73863,  30056, 103919
202895,13013, 0.1221378, 0.0944408, 0.1113328,  2315,  1145,  18954,  12124,  31078
202896,13013, 0.2376279, 0.0013197, 0.1454405,  4504,    16,  18954,  12124,  31078
202897,13013, 0.0000000, 0.0819037, 0.0319519,     0,   993,  18954,  12124,  31078
202902,15036, 0.0000000, 0.2493908, 0.0513496,     0,  2047,  31656,   8208,  39864
202902,13052, 0.0000000, 0.0344937, 0.0203700,     0,   653,  13126,  18931,  32057
202903,13052, 0.0000000, 0.0004754, 0.0002807,     0,     9,  13126,  18931,  32057
202904,15036, 0.0000000, 0.1653265, 0.0340407,     0,  1357,  31656,   8208,  39864
202907,13075, 0.0000000, 0.0003823, 0.0000756,     0,     1,  10612,   2616,  13228
202909,13083, 0.0000000, 0.0029118, 0.0015839,     0,    62,  17850,  21293,  39143
202910,13083, 0.0000000, 0.0005636, 0.0003066,     0,    12,  17850,  21293,  39143
202912,13051, 0.0000000, 0.0921090, 0.0101881,     0,  1298, 113312,  14092, 127404
202913,13022, 0.0000000, 0.1186457, 0.0914678,     0,  1265,   3168,  10662,  13830
202913,13051, 0.0000000, 0.0173148, 0.0019152,     0,   244, 113312,  14092, 127404
202914,13022, 0.0000000, 0.0072219, 0.0055676,     0,    77,   3168,  10662,  13830
202915,13022, 0.0000000, 0.0015007, 0.0011569,     0,    16,   3168,  10662,  13830
202916,13022, 0.9378157, 0.0057213, 0.2192335,  2971,    61,   3168,  10662,  13830
202917,13022, 0.0000000, 0.0213844, 0.0164859,     0,   228,   3168,  10662,  13830
202917,13057, 0.0000000, 0.0001856, 0.0001347,     0,     2,   4076,  10775,  14851
202918,13057, 0.0000000, 0.0111369, 0.0080803,     0,   120,   4076,  10775,  14851
202918,13022, 0.0000000, 0.0126618, 0.0097614,     0,   135,   3168,  10662,  13830
202920,13057, 0.0000000, 0.0491879, 0.0356878,     0,   530,   4076,  10775,  14851
202921,13057, 0.0000000, 0.0148492, 0.0107737,     0,   160,   4076,  10775,  14851
202923,13057, 0.0000000, 0.0042691, 0.0030974,     0,    46,   4076,  10775,  14851
202925,13056, 0.0000000, 0.0378607, 0.0128079,     0,   429,  22164,  11331,  33495
202926,13016, 0.0000000, 0.0077244, 0.0039083,     0,   213,  26925,  27575,  54500
202927,13016, 0.0017084, 0.0214687, 0.0117064,    46,   592,  26925,  27575,  54500
202928,13016, 0.0515135, 0.0894651, 0.0707156,  1387,  2467,  26925,  27575,  54500
202929,13016, 0.0229526, 0.0567906, 0.0400734,   618,  1566,  26925,  27575,  54500
202930,13016, 0.0670752, 0.0006528, 0.0334679,  1806,    18,  26925,  27575,  54500
202931,13016, 0.0000000, 0.0147597, 0.0074679,     0,   407,  26925,  27575,  54500
202932,13016, 0.0000000, 0.0056573, 0.0028624,     0,   156,  26925,  27575,  54500
202934,21208, 0.0000000, 0.0176032, 0.0083228,     0,   635,  40223,  36073,  76296
202935,21208, 0.0000000, 0.0016633, 0.0007864,     0,    60,  40223,  36073,  76296
202936,21208, 0.0000000, 0.0282206, 0.0133428,     0,  1018,  40223,  36073,  76296
202938,21208, 0.0000000, 0.0098966, 0.0046791,     0,   357,  40223,  36073,  76296
202939,21208, 0.0324193, 0.0218169, 0.0274064,  1304,   787,  40223,  36073,  76296
202940,21208, 0.0194913, 0.0128628, 0.0163573,   784,   464,  40223,  36073,  76296
202941,21208, 0.0000000, 0.0037979, 0.0017956,     0,   137,  40223,  36073,  76296
202942,21006, 0.0000000, 0.1456469, 0.1091907,     0,  1611,   3693,  11061,  14754
202943,21006, 0.0000000, 0.0026218, 0.0019656,     0,    29,   3693,  11061,  14754
202944,21167, 0.0000000, 0.1425579, 0.1262695,     0,  1293,   1170,   9070,  10240
202944,21006, 0.0000000, 0.1621915, 0.1215941,     0,  1794,   3693,  11061,  14754
202946,21215, 0.0000000, 0.0060060, 0.0004349,     0,     2,   4266,    333,   4599
202947,21215, 0.0096109, 0.0240240, 0.0106545,    41,     8,   4266,    333,   4599
202947,21162, 0.0000000, 0.6372924, 0.1175778,     0,   499,   3461,    783,   4244
202948,21215, 0.9903891, 0.9699700, 0.9889107,  4225,   323,   4266,    333,   4599
202949,21078, 0.4606112, 0.1930869, 0.2613360,  1643,  2011,   3567,  10415,  13982
202950,21202, 0.0000000, 0.1736948, 0.0988652,     0,  1211,   5277,   6972,  12249
202950,21078, 0.0000000, 0.2312050, 0.1722214,     0,  2408,   3567,  10415,  13982
202951,21202, 0.2507106, 0.0560815, 0.1399298,  1323,   391,   5277,   6972,  12249
202952,21101, 0.0000000, 0.0066834, 0.0044469,     0,    16,   1204,   2394,   3598
202952,21216, 0.0000000, 0.1216964, 0.0750284,     0,   198,   1012,   1627,   2639
203922,16017, 0.0000000, 0.0210636, 0.0183893,     0,   606,   4184,  28770,  32954
203923,22001, 0.0000000, 0.0098350, 0.0086178,     0,   536,   7698,  54499,  62197
203924,22001, 0.0000000, 0.0241105, 0.0211264,     0,  1314,   7698,  54499,  62197
203925,22001, 0.0000000, 0.0519643, 0.0455327,     0,  2832,   7698,  54499,  62197
203926,22001, 0.0000000, 0.0471752, 0.0413364,     0,  2571,   7698,  54499,  62197
203928,15001, 0.0000000, 0.0574219, 0.0494107,     0,  3010,   8499,  52419,  60918
203933,15003, 0.0000000, 0.0191945, 0.0167994,     0,   753,   5593,  39230,  44823
203934,15003, 0.0000000, 0.0022432, 0.0019633,     0,    88,   5593,  39230,  44823
203936,15003, 0.0000000, 0.0291104, 0.0254780,     0,  1142,   5593,  39230,  44823
203938,15003, 0.0000000, 0.0120571, 0.0105526,     0,   473,   5593,  39230,  44823
203940,15045, 0.0000000, 0.0280835, 0.0229718,     0,  1924,  15245,  68510,  83755
203943,15079, 0.0000000, 0.0448675, 0.0285642,     0,   337,   4287,   7511,  11798
203945,15079, 0.0000000, 0.1489815, 0.0948466,     0,  1119,   4287,   7511,  11798
203946,15079, 0.0000000, 0.1692185, 0.1077301,     0,  1271,   4287,   7511,  11798
203947,13076, 0.0000000, 0.0003660, 0.0001059,     0,    11,  73863,  30056, 103919
203948,13076, 0.0000000, 0.0531674, 0.0153774,     0,  1598,  73863,  30056, 103919
203949,13076, 0.0000000, 0.0518698, 0.0150021,     0,  1559,  73863,  30056, 103919
203950,13076, 0.2097397, 0.0754924, 0.1709120, 15492,  2269,  73863,  30056, 103919
203951,13076, 0.2332968, 0.0311419, 0.1748285, 17232,   936,  73863,  30056, 103919
203952,13076, 0.0760733, 0.0002662, 0.0541479,  5619,     8,  73863,  30056, 103919
203953,13010, 0.0000000, 0.0624388, 0.0118570,     0,   319,  21795,   5109,  26904
203954,13010, 0.2155999, 0.4194559, 0.2543116,  4699,  2143,  21795,   5109,  26904
203955,13010, 0.4229410, 0.0060677, 0.3437779,  9218,    31,  21795,   5109,  26904
203956,13010, 0.0204634, 0.0076336, 0.0180271,   446,    39,  21795,   5109,  26904
203957,13010, 0.0000000, 0.0001957, 0.0000372,     0,     1,  21795,   5109,  26904
203962,13052, 0.0000000, 0.0220274, 0.0130081,     0,   417,  13126,  18931,  32057
203964,13075, 0.0000000, 0.0045872, 0.0009072,     0,    12,  10612,   2616,  13228
203965,13052, 0.0000000, 0.0001056, 0.0000624,     0,     2,  13126,  18931,  32057
203966,13082, 0.0000000, 0.0068493, 0.0000554,     0,     1,  17890,    146,  18036
203968,13052, 0.0000000, 0.0485975, 0.0286989,     0,   920,  13126,  18931,  32057
203968,13048, 0.0000000, 0.0373902, 0.0007467,     0,   200, 262513,   5349, 267862
203969,13082, 0.0000000, 0.1027397, 0.0008317,     0,    15,  17890,    146,  18036
203969,13083, 0.0000000, 0.1895459, 0.1031091,     0,  4036,  17850,  21293,  39143
203969,13048, 0.0136565, 0.0134605, 0.0136526,  3585,    72, 262513,   5349, 267862
203970,13083, 0.0135014, 0.0381816, 0.0269269,   241,   813,  17850,  21293,  39143
203970,13048, 0.0452130, 0.0022434, 0.0443549, 11869,    12, 262513,   5349, 267862
203970,13051, 0.0000000, 0.0002838, 0.0000314,     0,     4, 113312,  14092, 127404
203971,13051, 0.0167943, 0.0146182, 0.0165536,  1903,   206, 113312,  14092, 127404
203972,13051, 0.0089223, 0.2487936, 0.0354541,  1011,  3506, 113312,  14092, 127404
203973,13051, 0.0137585, 0.0285268, 0.0153920,  1559,   402, 113312,  14092, 127404
203973,13022, 0.0000000, 0.0150066, 0.0115691,     0,   160,   3168,  10662,  13830
203974,13022, 0.0000000, 0.0049709, 0.0038322,     0,    53,   3168,  10662,  13830
203975,13022, 0.0621843, 0.0037516, 0.0171367,   197,    40,   3168,  10662,  13830
203976,13022, 0.0000000, 0.0493341, 0.0380333,     0,   526,   3168,  10662,  13830
203976,13057, 0.0000000, 0.0018561, 0.0013467,     0,    20,   4076,  10775,  14851
203977,13057, 0.0000000, 0.0116937, 0.0084843,     0,   126,   4076,  10775,  14851
203978,13057, 0.0000000, 0.0369374, 0.0267995,     0,   398,   4076,  10775,  14851
203979,13057, 0.0000000, 0.1085847, 0.0787826,     0,  1170,   4076,  10775,  14851
203980,13057, 0.0000000, 0.0417633, 0.0303010,     0,   450,   4076,  10775,  14851
203981,13056, 0.0000000, 0.0312417, 0.0105687,     0,   354,  22164,  11331,  33495
203981,13057, 0.0000000, 0.0005568, 0.0004040,     0,     6,   4076,  10775,  14851
203983,13056, 0.0000000, 0.1412938, 0.0477982,     0,  1601,  22164,  11331,  33495
203984,13056, 0.0512994, 0.1064337, 0.0699507,  1137,  1206,  22164,  11331,  33495
203985,13056, 0.4727937, 0.1459712, 0.3622332, 10479,  1654,  22164,  11331,  33495
203986,13016, 0.2596472, 0.1004533, 0.1791009,  6991,  2770,  26925,  27575,  54500
203987,13016, 0.2202414, 0.0792022, 0.1488807,  5930,  2184,  26925,  27575,  54500
203988,13016, 0.0000000, 0.0795648, 0.0402569,     0,  2194,  26925,  27575,  54500
203989,13016, 0.0000000, 0.0211423, 0.0106972,     0,   583,  26925,  27575,  54500
203990,13016, 0.0000000, 0.0109882, 0.0055596,     0,   303,  26925,  27575,  54500
203992,21008, 0.0284985, 0.1373057, 0.1128431,    67,  1113,   2351,   8106,  10457
203993,21208, 0.0000000, 0.0183517, 0.0086767,     0,   662,  40223,  36073,  76296
203993,21008, 0.0000000, 0.1248458, 0.0967773,     0,  1012,   2351,   8106,  10457
203994,21208, 0.0000000, 0.0157181, 0.0074316,     0,   567,  40223,  36073,  76296
203995,21208, 0.0000000, 0.0033820, 0.0015990,     0,   122,  40223,  36073,  76296
203996,21208, 0.0000000, 0.0009703, 0.0004587,     0,    35,  40223,  36073,  76296
203997,21208, 0.0000000, 0.0163003, 0.0077068,     0,   588,  40223,  36073,  76296
203998,21208, 0.0000000, 0.0130569, 0.0061733,     0,   471,  40223,  36073,  76296
203999,21208, 0.0000000, 0.0960552, 0.0454152,     0,  3465,  40223,  36073,  76296
204000,21208, 0.0000000, 0.0190170, 0.0089913,     0,   686,  40223,  36073,  76296
204001,21006, 0.0000000, 0.0332700, 0.0249424,     0,   368,   3693,  11061,  14754
204002,21006, 0.3081506, 0.3147998, 0.3131354,  1138,  3482,   3693,  11061,  14754
204003,21006, 0.0002708, 0.0437573, 0.0328724,     1,   484,   3693,  11061,  14754
204004,21162, 0.7165559, 0.0996169, 0.6027333,  2480,    78,   3461,    783,   4244
204005,21162, 0.0855244, 0.2630907, 0.1182846,   296,   206,   3461,    783,   4244
204005,21028, 0.0000000, 0.1466165, 0.0630048,     0,   156,   1412,   1064,   2476
204006,21028, 0.0000000, 0.6090226, 0.2617124,     0,   648,   1412,   1064,   2476
204007,21210, 1.0000000, 0.0549081, 0.3493224,  1747,   212,   1747,   3861,   5608
204008,21077, 0.0494315, 0.0067367, 0.0217998,   100,    25,   2023,   3711,   5734
204009,21210, 0.0000000, 0.9450920, 0.6506776,     0,  3649,   1747,   3861,   5608
204009,21084, 0.2402320, 0.2492221, 0.2448980,   787,   881,   3276,   3535,   6811
204009,21077, 0.0000000, 0.0070062, 0.0045344,     0,    26,   2023,   3711,   5734
204010,21084, 0.3656899, 0.3714286, 0.3686683,  1198,  1313,   3276,   3535,   6811
204010,21080, 1.0000000, 1.0000000, 1.0000000,  1554,  1279,   1554,   1279,   2833
204011,21216, 1.0000000, 0.4640442, 0.6695718,  1012,   755,   1012,   1627,   2639
204981,22001, 0.0000000, 0.0079268, 0.0069457,     0,   432,   7698,  54499,  62197
204982,22001, 0.0000000, 0.0241839, 0.0211907,     0,  1318,   7698,  54499,  62197
204983,22001, 0.0000000, 0.0194132, 0.0170105,     0,  1058,   7698,  54499,  62197
204984,22001, 0.0000000, 0.0082754, 0.0072512,     0,   451,   7698,  54499,  62197
204985,22001, 0.0000000, 0.0337254, 0.0295513,     0,  1838,   7698,  54499,  62197
204986,22001, 0.0000000, 0.0062386, 0.0054665,     0,   340,   7698,  54499,  62197
204987,22001, 0.0000000, 0.0103672, 0.0090840,     0,   565,   7698,  54499,  62197
204991,15003, 0.0000000, 0.0310732, 0.0271959,     0,  1219,   5593,  39230,  44823
204992,15003, 0.0000000, 0.0830487, 0.0726859,     0,  3258,   5593,  39230,  44823
204993,15003, 0.1144288, 0.0455519, 0.0541463,   640,  1787,   5593,  39230,  44823
204994,15003, 0.0000000, 0.0501912, 0.0439283,     0,  1969,   5593,  39230,  44823
204995,15003, 0.0000000, 0.0357125, 0.0312563,     0,  1401,   5593,  39230,  44823
204996,15003, 0.0000000, 0.0409635, 0.0358521,     0,  1607,   5593,  39230,  44823
204997,15003, 0.0000000, 0.0472088, 0.0413181,     0,  1852,   5593,  39230,  44823
204998,15045, 0.0000000, 0.0029777, 0.0024357,     0,   204,  15245,  68510,  83755
204999,15045, 0.0000000, 0.0283462, 0.0231867,     0,  1942,  15245,  68510,  83755
205000,15045, 0.0000000, 0.0126843, 0.0103755,     0,   869,  15245,  68510,  83755
205001,15045, 0.0000000, 0.0472632, 0.0386604,     0,  3238,  15245,  68510,  83755
205002,15079, 0.0000000, 0.1063773, 0.0677233,     0,   799,   4287,   7511,  11798
205003,15079, 0.0000000, 0.0214352, 0.0136464,     0,   161,   4287,   7511,  11798
205004,15079, 0.0000000, 0.0263613, 0.0167825,     0,   198,   4287,   7511,  11798
205005,15079, 0.0000000, 0.0304886, 0.0194101,     0,   229,   4287,   7511,  11798
205006,13076, 0.0000000, 0.0030610, 0.0008853,     0,    92,  73863,  30056, 103919
205009,13076, 0.0113724, 0.0019963, 0.0086606,   840,    60,  73863,  30056, 103919
205010,13076, 0.0903835, 0.0009316, 0.0645118,  6676,    28,  73863,  30056, 103919
205011,13076, 0.0017871, 0.0377961, 0.0122018,   132,  1136,  73863,  30056, 103919
205012,13010, 0.0000000, 0.0009787, 0.0001858,     0,     5,  21795,   5109,  26904
205012,13076, 0.0000000, 0.0238555, 0.0068996,     0,   717,  73863,  30056, 103919
205014,13010, 0.0670796, 0.4922685, 0.1478219,  1462,  2515,  21795,   5109,  26904
205014,13074, 0.1523085, 0.0184887, 0.1460872,  3886,    23,  25514,   1244,  26758
205015,13010, 0.0000000, 0.0109610, 0.0020815,     0,    56,  21795,   5109,  26904
205025,13052, 0.0000000, 0.0236649, 0.0139751,     0,   448,  13126,  18931,  32057
205026,13052, 0.0000000, 0.0003698, 0.0002184,     0,     7,  13126,  18931,  32057
205027,13048, 0.0000038, 0.0007478, 0.0000187,     1,     4, 262513,   5349, 267862
205028,13048, 0.0132946, 0.0372032, 0.0137720,  3490,   199, 262513,   5349, 267862
205029,13048, 0.1157466, 0.0052346, 0.1135398, 30385,    28, 262513,   5349, 267862
205030,13051, 0.1608126, 0.3768805, 0.1847116, 18222,  5311, 113312,  14092, 127404
205031,13051, 0.2132607, 0.0004967, 0.1897272, 24165,     7, 113312,  14092, 127404
205032,13022, 0.0000000, 0.0060026, 0.0046276,     0,    64,   3168,  10662,  13830
205033,13022, 0.0000000, 0.1718252, 0.1324657,     0,  1832,   3168,  10662,  13830
205033,13051, 0.0011208, 0.0340619, 0.0047644,   127,   480, 113312,  14092, 127404
205034,13022, 0.0000000, 0.1484712, 0.1144613,     0,  1583,   3168,  10662,  13830
205035,13022, 0.0000000, 0.0143500, 0.0110629,     0,   153,   3168,  10662,  13830
205036,13022, 0.0000000, 0.0374226, 0.0288503,     0,   399,   3168,  10662,  13830
205036,13057, 0.0000000, 0.0064037, 0.0046462,     0,    69,   4076,  10775,  14851
205037,13057, 0.0000000, 0.0186543, 0.0135344,     0,   201,   4076,  10775,  14851
205038,13057, 0.0000000, 0.0658005, 0.0477409,     0,   709,   4076,  10775,  14851
205039,13057, 0.0000000, 0.1402320, 0.1017440,     0,  1511,   4076,  10775,  14851
205040,13057, 0.0000000, 0.0545708, 0.0395933,     0,   588,   4076,  10775,  14851
205040,13056, 0.0000000, 0.0097961, 0.0033139,     0,   111,  22164,  11331,  33495
205040,13077, 0.0000000, 0.0846051, 0.0104233,     0,  1580, 132909,  18675, 151584
205041,13056, 0.0659628, 0.1197599, 0.0841618,  1462,  1357,  22164,  11331,  33495
205042,13056, 0.2086266, 0.2784397, 0.2322436,  4624,  3155,  22164,  11331,  33495
205042,13077, 0.0136108, 0.0315930, 0.0158262,  1809,   590, 132909,  18675, 151584
205043,13056, 0.0015340, 0.0391845, 0.0142708,    34,   444,  22164,  11331,  33495
205043,13077, 0.0143632, 0.0042303, 0.0131148,  1909,    79, 132909,  18675, 151584
205044,13056, 0.1997383, 0.0139440, 0.1368861,  4427,   158,  22164,  11331,  33495
205044,13016, 0.1559146, 0.0080145, 0.0810826,  4198,   221,  26925,  27575,  54500
205045,13016, 0.1715506, 0.0732185, 0.1217982,  4619,  2019,  26925,  27575,  54500
205046,13016, 0.0446425, 0.0598731, 0.0523486,  1202,  1651,  26925,  27575,  54500
205047,13016, 0.0000000, 0.0290118, 0.0146789,     0,   800,  26925,  27575,  54500
205049,13016, 0.0000000, 0.0163191, 0.0082569,     0,   450,  26925,  27575,  54500
205050,21008, 0.3781370, 0.0189983, 0.0997418,   889,   154,   2351,   8106,  10457
205050,13016, 0.0000000, 0.0296283, 0.0149908,     0,   817,  26925,  27575,  54500
205051,21008, 0.5861335, 0.1640760, 0.2589653,  1378,  1330,   2351,   8106,  10457
205052,21008, 0.0000000, 0.0434246, 0.0336617,     0,   352,   2351,   8106,  10457
205053,21008, 0.0000000, 0.0149272, 0.0115712,     0,   121,   2351,   8106,  10457
205053,21208, 0.0000000, 0.0046295, 0.0021888,     0,   167,  40223,  36073,  76296
205054,21208, 0.0000000, 0.0655338, 0.0309846,     0,  2364,  40223,  36073,  76296
205056,21049, 0.0000000, 0.0447125, 0.0352635,     0,   556,   3332,  12435,  15767
205057,21208, 0.0000000, 0.0014415, 0.0006816,     0,    52,  40223,  36073,  76296
205058,21208, 0.0000000, 0.0134727, 0.0063699,     0,   486,  40223,  36073,  76296
205059,21208, 0.0000000, 0.0199595, 0.0094369,     0,   720,  40223,  36073,  76296
205060,21208, 0.0000000, 0.0395587, 0.0187035,     0,  1427,  40223,  36073,  76296
205060,21006, 0.0000000, 0.1323569, 0.0992273,     0,  1464,   3693,  11061,  14754
205062,21006, 0.0056864, 0.1653558, 0.1253897,    21,  1829,   3693,  11061,  14754
205063,21014, 1.0000000, 0.3572003, 0.6806555,  2518,   888,   2518,   2486,   5004
205065,21028, 0.9900850, 0.1635338, 0.6348950,  1398,   174,   1412,   1064,   2476
205066,21077, 0.0000000, 0.1139854, 0.0737705,     0,   423,   2023,   3711,   5734
205067,21077, 0.9505684, 0.0299111, 0.3547262,  1923,   111,   2023,   3711,   5734
205068,21077, 0.0000000, 0.4861223, 0.3146146,     0,  1804,   2023,   3711,   5734
205068,21084, 0.2353480, 0.0834512, 0.1565115,   771,   295,   3276,   3535,   6811
205070,21072, 0.0000000, 0.0952244, 0.0845178,     0,  1326,   1764,  13925,  15689
206040,22001, 0.0000000, 0.0017798, 0.0015596,     0,    97,   7698,  54499,  62197
206041,22001, 0.0000000, 0.0328813, 0.0288117,     0,  1792,   7698,  54499,  62197
206042,22001, 0.0000000, 0.0206426, 0.0180877,     0,  1125,   7698,  54499,  62197
206043,22001, 0.0000000, 0.0123305, 0.0108044,     0,   672,   7698,  54499,  62197
206044,22001, 0.0000000, 0.0066790, 0.0058524,     0,   364,   7698,  54499,  62197
206045,22001, 0.0000000, 0.0028808, 0.0025242,     0,   157,   7698,  54499,  62197
206046,22001, 0.0000000, 0.0042386, 0.0037140,     0,   231,   7698,  54499,  62197
206047,22001, 0.0000000, 0.0224408, 0.0196633,     0,  1223,   7698,  54499,  62197
206048,22001, 0.0000000, 0.0036514, 0.0031995,     0,   199,   7698,  54499,  62197
206048,15003, 0.0000000, 0.0175376, 0.0153493,     0,   688,   5593,  39230,  44823
206049,15003, 0.0000000, 0.0081570, 0.0071392,     0,   320,   5593,  39230,  44823
206050,15003, 0.0000000, 0.0230691, 0.0201905,     0,   905,   5593,  39230,  44823
206051,15003, 0.0085822, 0.0544991, 0.0487696,    48,  2138,   5593,  39230,  44823
206052,15003, 0.2029322, 0.0153454, 0.0387524,  1135,   602,   5593,  39230,  44823
206053,15003, 0.0000000, 0.0189906, 0.0166209,     0,   745,   5593,  39230,  44823
206054,15003, 0.0000000, 0.0129238, 0.0113112,     0,   507,   5593,  39230,  44823
206055,15003, 0.0000000, 0.0571756, 0.0500413,     0,  2243,   5593,  39230,  44823
206057,15045, 0.0000000, 0.0246095, 0.0201301,     0,  1686,  15245,  68510,  83755
206058,15045, 0.0000000, 0.0042476, 0.0034744,     0,   291,  15245,  68510,  83755
206059,15045, 0.0000000, 0.0008612, 0.0007044,     0,    59,  15245,  68510,  83755
206062,15079, 0.0000000, 0.1449873, 0.0923038,     0,  1089,   4287,   7511,  11798
206064,13076, 0.0000000, 0.0280809, 0.0081217,     0,   844,  73863,  30056, 103919
206065,13076, 0.0000000, 0.0000665, 0.0000192,     0,     2,  73863,  30056, 103919
206066,13076, 0.0000000, 0.0643798, 0.0186203,     0,  1935,  73863,  30056, 103919
206067,13076, 0.0000000, 0.0819803, 0.0237108,     0,  2464,  73863,  30056, 103919
206067,13064, 0.0000000, 0.0201011, 0.0184105,     0,   183,    836,   9104,   9940
206068,13076, 0.0002843, 0.0624168, 0.0182546,    21,  1876,  73863,  30056, 103919
206069,13076, 0.0060517, 0.0286798, 0.0125963,   447,   862,  73863,  30056, 103919
206070,13067, 0.0000000, 0.0005125, 0.0001666,     0,     8,  32415,  15610,  48025
206071,13074, 0.0000000, 0.9083601, 0.0422304,     0,  1130,  25514,   1244,  26758
206073,13074, 0.3627028, 0.0490354, 0.3481202,  9254,    61,  25514,   1244,  26758
206075,13065, 0.7229179, 0.0045700, 0.5673146,  6293,    11,   8705,   2407,  11112
206077,13005, 0.0473061, 0.0018697, 0.0387570,   655,     6,  13846,   3209,  17055
206079,13005, 0.0000000, 0.1043939, 0.0196423,     0,   335,  13846,   3209,  17055
206080,13052, 0.0000000, 0.0354445, 0.0209315,     0,   671,  13126,  18931,  32057
206081,13052, 0.0000000, 0.0083461, 0.0049287,     0,   158,  13126,  18931,  32057
206082,13052, 0.0000000, 0.0008980, 0.0005303,     0,    17,  13126,  18931,  32057
206083,13052, 0.0000000, 0.0155301, 0.0091712,     0,   294,  13126,  18931,  32057
206084,13052, 0.1445223, 0.0009508, 0.0597373,  1897,    18,  13126,  18931,  32057
206085,13052, 0.2002895, 0.0002641, 0.0821661,  2629,     5,  13126,  18931,  32057
206086,13052, 0.0000000, 0.0001056, 0.0000624,     0,     2,  13126,  18931,  32057
206087,13048, 0.0053255, 0.1521780, 0.0082580,  1398,   814, 262513,   5349, 267862
206090,13051, 0.1740857, 0.0092961, 0.1558585, 19726,   131, 113312,  14092, 127404
206091,13051, 0.1239939, 0.1486659, 0.1267229, 14050,  2095, 113312,  14092, 127404
206092,13022, 0.0000000, 0.0023448, 0.0018077,     0,    25,   3168,  10662,  13830
206094,13022, 0.0000000, 0.0024386, 0.0018800,     0,    26,   3168,  10662,  13830
206098,13057, 0.0000000, 0.0105800, 0.0076763,     0,   114,   4076,  10775,  14851
206099,13001, 0.0000000, 0.0200793, 0.0196743,     0,   395,    405,  19672,  20077
206100,13077, 0.0031149, 0.0493708, 0.0088136,   414,   922, 132909,  18675, 151584
206101,13077, 0.0259576, 0.2256493, 0.0505594,  3450,  4214, 132909,  18675, 151584
206101,13056, 0.0000000, 0.0760745, 0.0257352,     0,   862,  22164,  11331,  33495
206102,13077, 0.1952614, 0.0602945, 0.1786336, 25952,  1126, 132909,  18675, 151584
206103,13077, 0.3902520, 0.0311111, 0.3460062, 51868,   581, 132909,  18675, 151584
206104,13016, 0.0000000, 0.0069266, 0.0035046,     0,   191,  26925,  27575,  54500
206104,13077, 0.0021218, 0.0116734, 0.0032985,   282,   218, 132909,  18675, 151584
206106,13002, 0.0000000, 0.0051139, 0.0029815,     0,   121,  16922,  23661,  40583
206106,13016, 0.0000000, 0.0007253, 0.0003670,     0,    20,  26925,  27575,  54500
206107,13016, 0.0000000, 0.0324569, 0.0164220,     0,   895,  26925,  27575,  54500
206107,13002, 0.0000000, 0.0379105, 0.0221029,     0,   897,  16922,  23661,  40583
206108,13002, 0.0000000, 0.0085795, 0.0050021,     0,   203,  16922,  23661,  40583
206109,13016, 0.0000000, 0.0253490, 0.0128257,     0,   699,  26925,  27575,  54500
206110,21008, 0.0000000, 0.0970886, 0.0752606,     0,   787,   2351,   8106,  10457
206111,21008, 0.0000000, 0.2880582, 0.2232954,     0,  2335,   2351,   8106,  10457
206115,21049, 0.0000000, 0.0464013, 0.0365954,     0,   577,   3332,  12435,  15767
206116,21049, 0.0000000, 0.0104544, 0.0082451,     0,   130,   3332,  12435,  15767
206117,21049, 0.0000000, 0.2676317, 0.2110738,     0,  3328,   3332,  12435,  15767
206118,21208, 0.0000000, 0.0298561, 0.0141161,     0,  1077,  40223,  36073,  76296
206118,21049, 0.0000000, 0.1601126, 0.1262764,     0,  1991,   3332,  12435,  15767
206121,21014, 0.0000000, 0.1942880, 0.0965228,     0,   483,   2518,   2486,   5004
206122,21014, 0.0000000, 0.4106999, 0.2040368,     0,  1021,   2518,   2486,   5004
206123,21068, 0.0000000, 0.0210591, 0.0178803,     0,   138,   1165,   6553,   7718
206124,21028, 0.0000000, 0.0808271, 0.0347334,     0,    86,   1412,   1064,   2476
206124,21030, 0.4743025, 0.8961039, 0.5171504,   323,    69,    681,     77,    758
206124,21014, 0.0000000, 0.0378117, 0.0187850,     0,    94,   2518,   2486,   5004
206124,21068, 0.0000000, 0.0692812, 0.0588235,     0,   454,   1165,   6553,   7718
206125,21030, 0.5256975, 0.1038961, 0.4828496,   358,     8,    681,     77,    758
206125,21107, 0.0000000, 0.0007178, 0.0006013,     0,     7,   1889,   9752,  11641
206126,21107, 0.0000000, 0.1200779, 0.1005927,     0,  1171,   1889,   9752,  11641
206127,21077, 0.0000000, 0.3562382, 0.2305546,     0,  1322,   2023,   3711,   5734
206127,21084, 0.0000000, 0.0113154, 0.0058729,     0,    40,   3276,   3535,   6811
206128,21084, 0.0000000, 0.2845827, 0.1477022,     0,  1006,   3276,   3535,   6811
206128,21029, 0.0336979, 0.4362745, 0.0770245,   114,   178,   3383,    408,   3791
207099,22001, 0.0000000, 0.0150461, 0.0131839,     0,   820,   7698,  54499,  62197
207100,22001, 0.0000000, 0.0044404, 0.0038909,     0,   242,   7698,  54499,  62197
207101,22001, 0.0000000, 0.0054680, 0.0047912,     0,   298,   7698,  54499,  62197
207102,22001, 0.0000000, 0.0186058, 0.0163030,     0,  1014,   7698,  54499,  62197
207103,22001, 0.0000000, 0.0077249, 0.0067688,     0,   421,   7698,  54499,  62197
207104,22001, 0.0000000, 0.0205508, 0.0180073,     0,  1120,   7698,  54499,  62197
207106,22001, 0.0000000, 0.0641113, 0.0561763,     0,  3494,   7698,  54499,  62197
207107,22001, 0.0000000, 0.0059818, 0.0052414,     0,   326,   7698,  54499,  62197
207107,15003, 0.0000000, 0.0247260, 0.0216407,     0,   970,   5593,  39230,  44823
207109,15003, 0.0815305, 0.0142748, 0.0226669,   456,   560,   5593,  39230,  44823
207110,15003, 0.0000000, 0.0067805, 0.0059345,     0,   266,   5593,  39230,  44823
207112,15003, 0.0000000, 0.0476421, 0.0416973,     0,  1869,   5593,  39230,  44823
207113,15003, 0.0000000, 0.0114963, 0.0100618,     0,   451,   5593,  39230,  44823
207114,15003, 0.0000000, 0.0270456, 0.0236709,     0,  1061,   5593,  39230,  44823
207114,15071, 0.0000000, 0.0456477, 0.0355330,     0,   462,   2881,  10121,  13002
207115,15045, 0.0000000, 0.0017224, 0.0014089,     0,   118,  15245,  68510,  83755
207117,15045, 0.0000000, 0.0293096, 0.0239747,     0,  2008,  15245,  68510,  83755
207119,15045, 0.0000000, 0.0460663, 0.0376813,     0,  3156,  15245,  68510,  83755
207120,15045, 0.0000000, 0.0164064, 0.0134201,     0,  1124,  15245,  68510,  83755
207123,13076, 0.0000000, 0.0953886, 0.0275888,     0,  2867,  73863,  30056, 103919
207126,13076, 0.0000000, 0.0098483, 0.0028484,     0,   296,  73863,  30056, 103919
207126,13064, 0.0000000, 0.0422891, 0.0387324,     0,   385,    836,   9104,   9940
207127,13064, 0.0000000, 0.0020870, 0.0019115,     0,    19,    836,   9104,   9940
207128,13076, 0.0107361, 0.0001996, 0.0076887,   793,     6,  73863,  30056, 103919
207130,13067, 0.0000000, 0.0183216, 0.0059552,     0,   286,  32415,  15610,  48025
207131,13070, 0.5152574, 0.1853535, 0.4771760,  7818,   367,  15173,   1980,  17153
207131,13074, 0.0000000, 0.0048232, 0.0002242,     0,     6,  25514,   1244,  26758
207131,13067, 0.0000000, 0.0167201, 0.0054347,     0,   261,  32415,  15610,  48025
207132,13074, 0.0496198, 0.0192926, 0.0482099,  1266,    24,  25514,   1244,  26758
207132,13070, 0.3735583, 0.0085859, 0.3314289,  5668,    17,  15173,   1980,  17153
207133,13070, 0.0496935, 0.0318182, 0.0476302,   754,    63,  15173,   1980,  17153
207134,13065, 0.1458932, 0.0037391, 0.1151008,  1270,     9,   8705,   2407,  11112
207136,13005, 0.0000000, 0.0666874, 0.0125476,     0,   214,  13846,   3209,  17055
207139,13005, 0.0000000, 0.1648489, 0.0310173,     0,   529,  13846,   3209,  17055
207140,13052, 0.0000000, 0.0279964, 0.0165331,     0,   530,  13126,  18931,  32057
207141,13052, 0.0000000, 0.0000528, 0.0000312,     0,     1,  13126,  18931,  32057
207142,13052, 0.0000000, 0.1466906, 0.0866269,     0,  2777,  13126,  18931,  32057
207143,13052, 0.2895018, 0.0167450, 0.1284275,  3800,   317,  13126,  18931,  32057
207144,13052, 0.1653207, 0.0479108, 0.0959853,  2170,   907,  13126,  18931,  32057
207145,13052, 0.0000000, 0.0116740, 0.0068940,     0,   221,  13126,  18931,  32057
207146,13048, 0.0115156, 0.0867452, 0.0130179,  3023,   464, 262513,   5349, 267862
207146,13052, 0.0000000, 0.0359727, 0.0212434,     0,   681,  13126,  18931,  32057
207147,13048, 0.1398331, 0.0029912, 0.1371005, 36708,    16, 262513,   5349, 267862
207148,13048, 0.2201834, 0.0022434, 0.2158313, 57801,    12, 262513,   5349, 267862
207149,13048, 0.2091973, 0.0031782, 0.2050832, 54917,    17, 262513,   5349, 267862
207150,13051, 0.0638679, 0.0148311, 0.0584440,  7237,   209, 113312,  14092, 127404
207151,13051, 0.0000000, 0.0141215, 0.0015620,     0,   199, 113312,  14092, 127404
207151,13039, 0.0100772, 0.0021060, 0.0084391,   111,     6,  11015,   2849,  13864
207152,13039, 0.0000000, 0.4183924, 0.0859781,     0,  1192,  11015,   2849,  13864
207153,13022, 0.0000000, 0.0477396, 0.0368041,     0,   509,   3168,  10662,  13830
207153,13039, 0.0000000, 0.1151281, 0.0236584,     0,   328,  11015,   2849,  13864
207158,13001, 0.0000000, 0.0068625, 0.0067241,     0,   135,    405,  19672,  20077
207159,13077, 0.0101874, 0.0558501, 0.0158130,  1354,  1043, 132909,  18675, 151584
207159,13001, 0.0000000, 0.0357869, 0.0350650,     0,   704,    405,  19672,  20077
207160,13077, 0.0604699, 0.0613655, 0.0605803,  8037,  1146, 132909,  18675, 151584
207161,13077, 0.0409905, 0.0154217, 0.0378404,  5448,   288, 132909,  18675, 151584
207162,13077, 0.0809953, 0.0537617, 0.0776401, 10765,  1004, 132909,  18675, 151584
207163,13077, 0.0000000, 0.0303614, 0.0037405,     0,   567, 132909,  18675, 151584
207164,13077, 0.0000000, 0.0088889, 0.0010951,     0,   166, 132909,  18675, 151584
207165,13077, 0.0000000, 0.0029451, 0.0003628,     0,    55, 132909,  18675, 151584
207166,13002, 0.0000000, 0.0027894, 0.0016263,     0,    66,  16922,  23661,  40583
207167,13002, 0.0022456, 0.0281476, 0.0173472,    38,   666,  16922,  23661,  40583
207169,21008, 0.0000000, 0.0516901, 0.0400689,     0,   419,   2351,   8106,  10457
207169,13002, 0.0010637, 0.0346562, 0.0206490,    18,   820,  16922,  23661,  40583
207170,21008, 0.0000000, 0.0595855, 0.0461892,     0,   483,   2351,   8106,  10457
207170,21071, 0.0000000, 0.0289398, 0.0082657,     0,   808,  69833,  27920,  97753
207172,21071, 0.0000000, 0.0310530, 0.0088693,     0,   867,  69833,  27920,  97753
207173,21071, 0.0000000, 0.0037249, 0.0010639,     0,   104,  69833,  27920,  97753
207174,21049, 0.0000000, 0.1526337, 0.1203780,     0,  1898,   3332,  12435,  15767
207175,21049, 0.0000000, 0.0236429, 0.0186465,     0,   294,   3332,  12435,  15767
207176,21049, 0.9990996, 0.0018496, 0.2125959,  3329,    23,   3332,  12435,  15767
207177,21183, 0.0000000, 0.1002693, 0.0488248,     0,   968,  10172,   9654,  19826
207179,21184, 0.0000000, 0.0565248, 0.0505776,     0,   324,    674,   5732,   6406
207180,21123, 0.0000000, 0.0664677, 0.0594660,     0,   245,    434,   3686,   4120
207180,21184, 0.0000000, 0.0036636, 0.0032782,     0,    21,    674,   5732,   6406
207181,21123, 1.0000000, 0.2756375, 0.3519417,   434,  1016,    434,   3686,   4120
207182,21123, 0.0000000, 0.2072708, 0.1854369,     0,   764,    434,   3686,   4120
207183,21068, 0.0000000, 0.3077980, 0.2613371,     0,  2017,   1165,   6553,   7718
207184,21068, 0.0000000, 0.0350984, 0.0298005,     0,   230,   1165,   6553,   7718
207185,21107, 0.9793541, 0.1232568, 0.2621768,  1850,  1202,   1889,   9752,  11641
207186,21072, 0.0000000, 0.0929982, 0.0825419,     0,  1295,   1764,  13925,  15689
207187,21072, 0.5005669, 0.3067145, 0.3285104,   883,  4271,   1764,  13925,  15689
207188,21029, 0.0000000, 0.5637255, 0.0606700,     0,   230,   3383,    408,   3791
208158,22001, 0.0114315, 0.0100002, 0.0101773,    88,   545,   7698,  54499,  62197
208159,22001, 0.1693946, 0.0388998, 0.0550509,  1304,  2120,   7698,  54499,  62197
208161,22001, 0.0000000, 0.0164223, 0.0143898,     0,   895,   7698,  54499,  62197
208162,22001, 0.0000000, 0.0064221, 0.0056273,     0,   350,   7698,  54499,  62197
208163,22001, 0.0000000, 0.0064405, 0.0056434,     0,   351,   7698,  54499,  62197
208164,22001, 0.0000000, 0.0291748, 0.0255639,     0,  1590,   7698,  54499,  62197
208165,22001, 0.0000000, 0.0427347, 0.0374455,     0,  2329,   7698,  54499,  62197
208167,15003, 0.3068121, 0.0318124, 0.0661268,  1716,  1248,   5593,  39230,  44823
208168,15003, 0.1332022, 0.0272750, 0.0404926,   745,  1070,   5593,  39230,  44823
208169,15003, 0.0000000, 0.0032883, 0.0028780,     0,   129,   5593,  39230,  44823
208170,15003, 0.0000000, 0.0012745, 0.0011155,     0,    50,   5593,  39230,  44823
208172,15003, 0.0000000, 0.0002804, 0.0002454,     0,    11,   5593,  39230,  44823
208172,15071, 0.0000000, 0.0400158, 0.0311491,     0,   405,   2881,  10121,  13002
208174,15071, 0.0000000, 0.0398182, 0.0309952,     0,   403,   2881,  10121,  13002
208175,15045, 0.0000000, 0.0036929, 0.0030207,     0,   253,  15245,  68510,  83755
208176,13044, 0.0000000, 0.0069173, 0.0064471,     0,   101,   1065,  14601,  15666
208178,13044, 0.0000000, 0.0066434, 0.0061918,     0,    97,   1065,  14601,  15666
208180,15045, 0.0000000, 0.0022478, 0.0018387,     0,   154,  15245,  68510,  83755
208180,13044, 0.0000000, 0.0367098, 0.0342142,     0,   536,   1065,  14601,  15666
208183,13064, 0.0000000, 0.0041740, 0.0038229,     0,    38,    836,   9104,   9940
208185,13064, 0.0000000, 0.2419816, 0.2216298,     0,  2203,    836,   9104,   9940
208186,13064, 0.0000000, 0.2068322, 0.1894366,     0,  1883,    836,   9104,   9940
208186,13067, 0.0191269, 0.0033312, 0.0139927,   620,    52,  32415,  15610,  48025
208187,13067, 0.0544501, 0.0217168, 0.0438105,  1765,   339,  32415,  15610,  48025
208188,13067, 0.0130495, 0.0004484, 0.0089537,   423,     7,  32415,  15610,  48025
208189,13067, 0.1623631, 0.0739910, 0.1336387,  5263,  1155,  32415,  15610,  48025
208190,13067, 0.1248496, 0.0876361, 0.1127538,  4047,  1368,  32415,  15610,  48025
208190,13070, 0.0614908, 0.0121212, 0.0557920,   933,    24,  15173,   1980,  17153
208191,13070, 0.0000000, 0.7621212, 0.0879729,     0,  1509,  15173,   1980,  17153
208191,13041, 0.0000000, 0.0407392, 0.0138441,     0,   593,  28278,  14556,  42834
208192,13065, 0.0000000, 0.9916909, 0.2148128,     0,  2387,   8705,   2407,  11112
208196,13005, 0.0000000, 0.0003116, 0.0000586,     0,     1,  13846,   3209,  17055
208197,13005, 0.0075834, 0.1103147, 0.0269129,   105,   354,  13846,   3209,  17055
208198,13005, 0.0000000, 0.0024930, 0.0004691,     0,     8,  13846,   3209,  17055
208199,13052, 0.0000000, 0.0202314, 0.0119475,     0,   383,  13126,  18931,  32057
208200,13052, 0.0000000, 0.0001056, 0.0000624,     0,     2,  13126,  18931,  32057
208201,13052, 0.0000000, 0.0898526, 0.0530617,     0,  1701,  13126,  18931,  32057
208202,13052, 0.0000000, 0.0945539, 0.0558380,     0,  1790,  13126,  18931,  32057
208203,13052, 0.0000000, 0.1226031, 0.0724023,     0,  2321,  13126,  18931,  32057
208204,13009, 0.0000000, 0.0108026, 0.0089789,     0,   156,   2933,  14441,  17374
208204,13038, 0.0000000, 0.1596213, 0.1500000,     0,  1197,    481,   7499,   7980
208205,13052, 0.1464269, 0.0140510, 0.0682534,  1922,   266,  13126,  18931,  32057
208206,13048, 0.0203418, 0.0014956, 0.0199655,  5340,     8, 262513,   5349, 267862
208207,13048, 0.0056797, 0.0620677, 0.0068057,  1491,   332, 262513,   5349, 267862
208207,13038, 0.0000000, 0.0144019, 0.0135338,     0,   108,    481,   7499,   7980
208208,13048, 0.0280900, 0.5928211, 0.0393673,  7374,  3171, 262513,   5349, 267862
208209,13039, 0.1795733, 0.0084240, 0.1444028,  1978,    24,  11015,   2849,  13864
208210,13039, 0.8103495, 0.1526852, 0.6752020,  8926,   435,  11015,   2849,  13864
208210,13045, 0.0000000, 0.0307964, 0.0272230,     0,   244,   1040,   7923,   8963
208211,13039, 0.0000000, 0.0207090, 0.0042556,     0,    59,  11015,   2849,  13864
208211,13045, 0.0000000, 0.0862047, 0.0762022,     0,   683,   1040,   7923,   8963
208212,13045, 0.0000000, 0.2199924, 0.1944661,     0,  1743,   1040,   7923,   8963
208213,13045, 0.0000000, 0.0268838, 0.0237644,     0,   213,   1040,   7923,   8963
208216,13001, 0.0000000, 0.0343127, 0.0336206,     0,   675,    405,  19672,  20077
208216,13024, 0.0000000, 0.0433790, 0.0420207,     0,   722,    538,  16644,  17182
208217,13001, 0.0000000, 0.0616612, 0.0604174,     0,  1213,    405,  19672,  20077
208218,13001, 1.0000000, 0.2602176, 0.2751407,   405,  5119,    405,  19672,  20077
208219,13001, 0.0000000, 0.0190626, 0.0186781,     0,   375,    405,  19672,  20077
208220,13077, 0.0097962, 0.0085141, 0.0096382,  1302,   159, 132909,  18675, 151584
208221,13077, 0.0485595, 0.0495315, 0.0486793,  6454,   925, 132909,  18675, 151584
208223,13077, 0.0005793, 0.0482999, 0.0064585,    77,   902, 132909,  18675, 151584
208225,13002, 0.0000000, 0.0021977, 0.0012813,     0,    52,  16922,  23661,  40583
208226,13002, 0.0000000, 0.0771734, 0.0449942,     0,  1826,  16922,  23661,  40583
208227,13002, 0.1513415, 0.0024936, 0.0645590,  2561,    59,  16922,  23661,  40583
208228,13002, 0.0452665, 0.0150036, 0.0276224,   766,   355,  16922,  23661,  40583
208229,13002, 0.0000000, 0.0903597, 0.0526822,     0,  2138,  16922,  23661,  40583
208230,21071, 0.0000000, 0.0603152, 0.0172271,     0,  1684,  69833,  27920,  97753
208231,21071, 0.0000000, 0.0248209, 0.0070893,     0,   693,  69833,  27920,  97753
208232,21071, 0.0000000, 0.0643625, 0.0183831,     0,  1797,  69833,  27920,  97753
208233,21071, 0.0000000, 0.0796203, 0.0227410,     0,  2223,  69833,  27920,  97753
208234,21049, 0.0000000, 0.2829916, 0.2231877,     0,  3519,   3332,  12435,  15767
208235,21049, 0.0000000, 0.0095698, 0.0075474,     0,   119,   3332,  12435,  15767
208236,21183, 0.1270153, 0.0629791, 0.0958337,  1292,   608,  10172,   9654,  19826
208238,21184, 1.0000000, 0.1693999, 0.2567905,   674,   971,    674,   5732,   6406
208239,21184, 0.0000000, 0.2573273, 0.2302529,     0,  1475,    674,   5732,   6406
208240,21123, 0.0000000, 0.0005426, 0.0004854,     0,     2,    434,   3686,   4120
208241,21123, 0.0000000, 0.2588171, 0.2315534,     0,   954,    434,   3686,   4120
208242,21068, 1.0000000, 0.2340913, 0.3497020,  1165,  1534,   1165,   6553,   7718
208243,21068, 0.0000000, 0.0781322, 0.0663384,     0,   512,   1165,   6553,   7718
208244,21107, 0.0206458, 0.0630640, 0.0561807,    39,   615,   1889,   9752,  11641
208245,21107, 0.0000000, 0.2751231, 0.2304785,     0,  2683,   1889,   9752,  11641
208246,21072, 0.4994331, 0.1575584, 0.1959972,   881,  2194,   1764,  13925,  15689
208246,21107, 0.0000000, 0.1148482, 0.0962117,     0,  1120,   1889,   9752,  11641
208247,21072, 0.0000000, 0.2526391, 0.2242335,     0,  3518,   1764,  13925,  15689
208247,30203, 0.0000000, 0.0256536, 0.0256536,     0,   262,      0,  10213,  10213
209217,22001, 0.4214081, 0.0230463, 0.0723508,  3244,  1256,   7698,  54499,  62197
209218,22001, 0.3977657, 0.0130094, 0.0606299,  3062,   709,   7698,  54499,  62197
209219,22001, 0.0000000, 0.0020184, 0.0017686,     0,   110,   7698,  54499,  62197
209220,22001, 0.0000000, 0.0104406, 0.0091484,     0,   569,   7698,  54499,  62197
209221,22001, 0.0000000, 0.0063854, 0.0055951,     0,   348,   7698,  54499,  62197
209222,22001, 0.0000000, 0.0075598, 0.0066241,     0,   412,   7698,  54499,  62197
209223,22001, 0.0000000, 0.0127709, 0.0111903,     0,   696,   7698,  54499,  62197
209224,15003, 0.0000000, 0.0064746, 0.0056667,     0,   254,   5593,  39230,  44823
209225,15003, 0.0000000, 0.0027275, 0.0023872,     0,   107,   5593,  39230,  44823
209227,15003, 0.0000000, 0.0136120, 0.0119135,     0,   534,   5593,  39230,  44823
209228,15003, 0.0000000, 0.0227377, 0.0199005,     0,   892,   5593,  39230,  44823
209229,15071, 0.0000000, 0.0128446, 0.0099985,     0,   130,   2881,  10121,  13002
209230,15071, 0.0000000, 0.0166980, 0.0129980,     0,   169,   2881,  10121,  13002
209231,15071, 0.0000000, 0.0507855, 0.0395324,     0,   514,   2881,  10121,  13002
209231,13044, 0.0000000, 0.0002055, 0.0001915,     0,     3,   1065,  14601,  15666
209232,13044, 0.0000000, 0.0020547, 0.0019150,     0,    30,   1065,  14601,  15666
209233,13044, 0.0000000, 0.0343127, 0.0319801,     0,   501,   1065,  14601,  15666
209234,13044, 0.0000000, 0.0041093, 0.0038300,     0,    60,   1065,  14601,  15666
209235,13044, 0.0000000, 0.0174646, 0.0162773,     0,   255,   1065,  14601,  15666
209236,13044, 0.0000000, 0.0075337, 0.0070216,     0,   110,   1065,  14601,  15666
209237,13044, 0.0000000, 0.0076022, 0.0070854,     0,   111,   1065,  14601,  15666
209238,13044, 0.0000000, 0.0106842, 0.0099579,     0,   156,   1065,  14601,  15666
209239,13044, 0.0000000, 0.0076022, 0.0070854,     0,   111,   1065,  14601,  15666
209240,13017, 0.0000000, 0.0511887, 0.0435172,     0,   534,   1839,  10432,  12271
209241,13017, 0.0000000, 0.0262653, 0.0223291,     0,   274,   1839,  10432,  12271
209244,13064, 1.0000000, 0.2882250, 0.3480885,   836,  2624,    836,   9104,   9940
209245,13064, 0.0000000, 0.0018673, 0.0017103,     0,    17,    836,   9104,   9940
209245,13067, 0.0125251, 0.0254324, 0.0167205,   406,   397,  32415,  15610,  48025
209247,13067, 0.0025914, 0.2851377, 0.0944300,    84,  4451,  32415,  15610,  48025
209248,13067, 0.3492827, 0.0862268, 0.2637793, 11322,  1346,  32415,  15610,  48025
209249,13067, 0.0785747, 0.1100577, 0.0888079,  2547,  1718,  32415,  15610,  48025
209250,13041, 0.0000000, 0.0747458, 0.0254004,     0,  1088,  28278,  14556,  42834
209251,13041, 0.0732725, 0.1029816, 0.0833683,  2072,  1499,  28278,  14556,  42834
209252,13041, 0.0000000, 0.0011679, 0.0003969,     0,    17,  28278,  14556,  42834
209254,13005, 0.0280948, 0.0009349, 0.0229845,   389,     3,  13846,   3209,  17055
209255,13005, 0.0138668, 0.4904955, 0.1035473,   192,  1574,  13846,   3209,  17055
209257,13005, 0.0325726, 0.0576504, 0.0372911,   451,   185,  13846,   3209,  17055
209258,13052, 0.0000000, 0.0010565, 0.0006239,     0,    20,  13126,  18931,  32057
209259,13052, 0.0000000, 0.0389309, 0.0229903,     0,   737,  13126,  18931,  32057
209260,13052, 0.0000000, 0.0377687, 0.0223040,     0,   715,  13126,  18931,  32057
209261,13009, 0.0000000, 0.1240219, 0.1030851,     0,  1791,   2933,  14441,  17374
209262,13009, 0.0000000, 0.0071325, 0.0059284,     0,   103,   2933,  14441,  17374
209263,13009, 0.0000000, 0.0322000, 0.0267641,     0,   465,   2933,  14441,  17374
209264,13052, 0.0230840, 0.0028525, 0.0111364,   303,    54,  13126,  18931,  32057
209264,13038, 0.0000000, 0.0453394, 0.0426065,     0,   340,    481,   7499,   7980
209266,13038, 0.0000000, 0.2462995, 0.2314536,     0,  1847,    481,   7499,   7980
209268,13039, 0.0000000, 0.2699193, 0.0554674,     0,   769,  11015,   2849,  13864
209269,13045, 0.3923077, 0.0526316, 0.0920451,   408,   417,   1040,   7923,   8963
209269,13039, 0.0000000, 0.0126360, 0.0025967,     0,    36,  11015,   2849,  13864
209270,13045, 0.6076923, 0.1871766, 0.2359701,   632,  1483,   1040,   7923,   8963
209271,13045, 0.0000000, 0.0223400, 0.0197479,     0,   177,   1040,   7923,   8963
209272,13024, 0.0000000, 0.0015020, 0.0014550,     0,    25,    538,  16644,  17182
209273,13024, 0.0000000, 0.0183850, 0.0178093,     0,   306,    538,  16644,  17182
209274,13024, 0.0000000, 0.0171233, 0.0165871,     0,   285,    538,  16644,  17182
209275,13001, 0.0000000, 0.0011183, 0.0010958,     0,    22,    405,  19672,  20077
209276,13001, 0.0000000, 0.0167243, 0.0163869,     0,   329,    405,  19672,  20077
209277,13001, 0.0000000, 0.0506812, 0.0496588,     0,   997,    405,  19672,  20077
209278,13001, 0.0000000, 0.0195710, 0.0191762,     0,   385,    405,  19672,  20077
209279,13001, 0.0000000, 0.0899248, 0.0881108,     0,  1769,    405,  19672,  20077
209279,13077, 0.0000000, 0.0004819, 0.0000594,     0,     9, 132909,  18675, 151584
209280,13077, 0.0000000, 0.0671486, 0.0082726,     0,  1254, 132909,  18675, 151584
209281,13077, 0.0231361, 0.0493173, 0.0263616,  3075,   921, 132909,  18675, 151584
209282,13077, 0.0111053, 0.0060509, 0.0104826,  1476,   113, 132909,  18675, 151584
209282,13002, 0.0000000, 0.0059169, 0.0034497,     0,   140,  16922,  23661,  40583
209283,13002, 0.0000000, 0.0801319, 0.0467191,     0,  1896,  16922,  23661,  40583
209284,13002, 0.0000000, 0.0512235, 0.0298647,     0,  1212,  16922,  23661,  40583
209285,13002, 0.2379151, 0.0989392, 0.1568884,  4026,  2341,  16922,  23661,  40583
209286,13002, 0.1194894, 0.0073539, 0.0541113,  2022,   174,  16922,  23661,  40583
209288,21071, 0.0000000, 0.0691977, 0.0197641,     0,  1932,  69833,  27920,  97753
209288,13002, 0.0000000, 0.0050716, 0.0029569,     0,   120,  16922,  23661,  40583
209289,21071, 0.0373606, 0.0129656, 0.0303929,  2609,   362,  69833,  27920,  97753
209290,21071, 0.2396718, 0.0092407, 0.1738566, 16737,   258,  69833,  27920,  97753
209291,21071, 0.0786877, 0.0374642, 0.0669135,  5495,  1046,  69833,  27920,  97753
209292,21071, 0.0000000, 0.1045487, 0.0298610,     0,  2919,  69833,  27920,  97753
209293,21071, 0.0000000, 0.0248567, 0.0070995,     0,   694,  69833,  27920,  97753
209293,21183, 0.0186787, 0.0014502, 0.0102895,   190,    14,  10172,   9654,  19826
209294,21183, 0.2116595, 0.0430909, 0.1295773,  2153,   416,  10172,   9654,  19826
209295,21183, 0.0112072, 0.1146675, 0.0615858,   114,  1107,  10172,   9654,  19826
209296,21183, 0.0000000, 0.2226020, 0.1083930,     0,  2149,  10172,   9654,  19826
209297,21184, 0.0000000, 0.0326239, 0.0291914,     0,   187,    674,   5732,   6406
209297,21183, 0.0000000, 0.0103584, 0.0050439,     0,   100,  10172,   9654,  19826
209298,21184, 0.0000000, 0.0439637, 0.0393381,     0,   252,    674,   5732,   6406
209299,21184, 0.0000000, 0.2749477, 0.2460194,     0,  1576,    674,   5732,   6406
209300,21123, 0.0000000, 0.1877374, 0.1679612,     0,   692,    434,   3686,   4120
209301,21068, 0.0000000, 0.0164810, 0.0139933,     0,   108,   1165,   6553,   7718
209301,21123, 0.0000000, 0.0035269, 0.0031553,     0,    13,    434,   3686,   4120
209301,21089, 0.0000000, 0.2165001, 0.1316458,     0,  1711,   5094,   7903,  12997
209302,21068, 0.0000000, 0.2380589, 0.2021249,     0,  1560,   1165,   6553,   7718
209303,21089, 0.0422065, 0.0620018, 0.0542433,   215,   490,   5094,   7903,  12997
209304,21107, 0.0000000, 0.1452010, 0.1216390,     0,  1416,   1889,   9752,  11641
209304,21089, 0.0000000, 0.0105023, 0.0063861,     0,    83,   5094,   7903,  12997
209305,21107, 0.0000000, 0.0228671, 0.0191564,     0,   223,   1889,   9752,  11641
209305,21072, 0.0000000, 0.0948654, 0.0841991,     0,  1321,   1764,  13925,  15689
209306,30203, 0.0000000, 0.1408989, 0.1408989,     0,  1439,      0,  10213,  10213
210276,22001, 0.0000000, 0.0029909, 0.0026207,     0,   163,   7698,  54499,  62197
210277,22001, 0.0000000, 0.0010092, 0.0008843,     0,    55,   7698,  54499,  62197
210278,22001, 0.0000000, 0.0184407, 0.0161583,     0,  1005,   7698,  54499,  62197
210283,15003, 0.0000000, 0.0169513, 0.0148361,     0,   665,   5593,  39230,  44823
210284,22016, 0.0000000, 0.0007060, 0.0001862,     0,    45, 177956,  63743, 241699
210285,15003, 0.0000000, 0.0020647, 0.0018071,     0,    81,   5593,  39230,  44823
210285,15071, 0.0000000, 0.0495998, 0.0386094,     0,   502,   2881,  10121,  13002
210286,15071, 0.0000000, 0.0395218, 0.0307645,     0,   400,   2881,  10121,  13002
210287,15071, 0.0000000, 0.0678787, 0.0528380,     0,   687,   2881,  10121,  13002
210288,15071, 0.9517528, 0.0631361, 0.2600369,  2742,   639,   2881,  10121,  13002
210289,15071, 0.0124957, 0.0816125, 0.0662975,    36,   826,   2881,  10121,  13002
210290,13044, 0.0000000, 0.0418465, 0.0390017,     0,   611,   1065,  14601,  15666
210291,13044, 0.0000000, 0.0341073, 0.0317886,     0,   498,   1065,  14601,  15666
210292,13044, 0.0000000, 0.0453394, 0.0422571,     0,   662,   1065,  14601,  15666
210293,13044, 0.0000000, 0.0285597, 0.0266182,     0,   417,   1065,  14601,  15666
210294,13044, 0.0000000, 0.0141086, 0.0131495,     0,   206,   1065,  14601,  15666
210295,13044, 0.0000000, 0.0318471, 0.0296821,     0,   465,   1065,  14601,  15666
210296,13044, 0.0000000, 0.0816382, 0.0760883,     0,  1192,   1065,  14601,  15666
210297,13044, 0.0000000, 0.0013013, 0.0012128,     0,    19,   1065,  14601,  15666
210297,13017, 0.0000000, 0.0278949, 0.0237144,     0,   291,   1839,  10432,  12271
210298,13017, 0.0000000, 0.0053681, 0.0045636,     0,    56,   1839,  10432,  12271
210299,13017, 0.0000000, 0.1414877, 0.1202836,     0,  1476,   1839,  10432,  12271
210301,13017, 0.0000000, 0.0046971, 0.0039932,     0,    49,   1839,  10432,  12271
210301,13064, 0.0000000, 0.0219684, 0.0201207,     0,   200,    836,   9104,   9940
210302,13064, 0.0000000, 0.0095562, 0.0087525,     0,    87,    836,   9104,   9940
210307,13067, 0.0636742, 0.0626521, 0.0633420,  2064,   978,  32415,  15610,  48025
210308,13041, 0.0828206, 0.0179994, 0.0607928,  2342,   262,  28278,  14556,  42834
210309,13041, 0.1036848, 0.1322479, 0.1133912,  2932,  1925,  28278,  14556,  42834
210310,13041, 0.0246128, 0.0581891, 0.0360228,   696,   847,  28278,  14556,  42834
210311,13041, 0.0000000, 0.0001374, 0.0000467,     0,     2,  28278,  14556,  42834
210313,13023, 0.0006546, 0.0972433, 0.0363116,    14,  1217,  21386,  12515,  33901
210314,13023, 0.2204713, 0.0031962, 0.1402614,  4715,    40,  21386,  12515,  33901
210315,13023, 0.0484897, 0.0118258, 0.0349547,  1037,   148,  21386,  12515,  33901
210316,13054, 0.0000000, 0.0413634, 0.0327709,     0,  1074,   6808,  25965,  32773
210317,13003, 0.0003428, 0.0089744, 0.0029466,    13,   147,  37919,  16380,  54299
210317,13054, 0.0000000, 0.0522627, 0.0414060,     0,  1357,   6808,  25965,  32773
210318,13009, 0.0000000, 0.0296378, 0.0246345,     0,   428,   2933,  14441,  17374
210318,13003, 0.0532714, 0.1116606, 0.0708853,  2020,  1829,  37919,  16380,  54299
210319,13009, 0.0231845, 0.1301156, 0.1120640,    68,  1879,   2933,  14441,  17374
210320,13009, 0.1633140, 0.1221522, 0.1291009,   479,  1764,   2933,  14441,  17374
210321,13009, 0.0000000, 0.0828890, 0.0688961,     0,  1197,   2933,  14441,  17374
210322,13009, 0.0000000, 0.0081019, 0.0067342,     0,   117,   2933,  14441,  17374
210323,13038, 0.0000000, 0.0077344, 0.0072682,     0,    58,    481,   7499,   7980
210324,13038, 0.0000000, 0.0249367, 0.0234336,     0,   187,    481,   7499,   7980
210327,13038, 0.0000000, 0.0322710, 0.0303258,     0,   242,    481,   7499,   7980
210328,13045, 0.0000000, 0.0396315, 0.0350329,     0,   314,   1040,   7923,   8963
210328,13038, 0.0000000, 0.0052007, 0.0048872,     0,    39,    481,   7499,   7980
210329,13045, 0.0000000, 0.1780891, 0.1574250,     0,  1411,   1040,   7923,   8963
210330,13024, 0.0000000, 0.0722783, 0.0700151,     0,  1203,    538,  16644,  17182
210331,13024, 0.9981413, 0.0963711, 0.1246071,   537,  1604,    538,  16644,  17182
210332,13024, 0.0000000, 0.0254746, 0.0246770,     0,   424,    538,  16644,  17182
210334,13024, 0.0000000, 0.1114516, 0.1079618,     0,  1855,    538,  16644,  17182
210335,13001, 0.0000000, 0.0223668, 0.0219156,     0,   440,    405,  19672,  20077
210335,13024, 0.0000000, 0.0285989, 0.0277034,     0,   476,    538,  16644,  17182
210336,13001, 0.0000000, 0.0662363, 0.0649001,     0,  1303,    405,  19672,  20077
210337,13001, 0.0000000, 0.0492578, 0.0482642,     0,   969,    405,  19672,  20077
210339,13077, 0.0000000, 0.0209906, 0.0025860,     0,   392, 132909,  18675, 151584
210340,13077, 0.0129939, 0.0080857, 0.0123892,  1727,   151, 132909,  18675, 151584
210341,13077, 0.0000527, 0.0144578, 0.0018274,     7,   270, 132909,  18675, 151584
210341,13002, 0.0000000, 0.0065931, 0.0038440,     0,   156,  16922,  23661,  40583
210342,13002, 0.0000000, 0.1164786, 0.0679102,     0,  2756,  16922,  23661,  40583
210343,13002, 0.0000000, 0.0014370, 0.0008378,     0,    34,  16922,  23661,  40583
210344,13002, 0.2065950, 0.0072271, 0.0903580,  3496,   171,  16922,  23661,  40583
210345,13002, 0.0000000, 0.0849077, 0.0495035,     0,  2009,  16922,  23661,  40583
210346,13002, 0.0000000, 0.0901061, 0.0525343,     0,  2132,  16922,  23661,  40583
210347,21100, 0.0000000, 0.0118513, 0.0097868,     0,    95,   1691,   8016,   9707
210348,21071, 0.0345109, 0.0067693, 0.0265874,  2410,   189,  69833,  27920,  97753
210349,21071, 0.3520399, 0.0094556, 0.2541917, 24584,   264,  69833,  27920,  97753
210350,21071, 0.1062821, 0.0148997, 0.0801817,  7422,   416,  69833,  27920,  97753
210351,21071, 0.0000000, 0.0733524, 0.0209508,     0,  2048,  69833,  27920,  97753
210352,21183, 0.3510617, 0.0205096, 0.1901039,  3571,   198,  10172,   9654,  19826
210353,21183, 0.0000000, 0.0794489, 0.0386866,     0,   767,  10172,   9654,  19826
210354,21183, 0.0028510, 0.0923969, 0.0464542,    29,   892,  10172,   9654,  19826
210355,21183, 0.0523004, 0.0914647, 0.0713709,   532,   883,  10172,   9654,  19826
210356,21183, 0.0000000, 0.0114978, 0.0055987,     0,   111,  10172,   9654,  19826
210357,21184, 0.0000000, 0.1615492, 0.1445520,     0,   926,    674,   5732,   6406
210357,21183, 0.0000000, 0.0453698, 0.0220922,     0,   438,  10172,   9654,  19826
210360,21089, 0.0000000, 0.0040491, 0.0024621,     0,    32,   5094,   7903,  12997
210362,21089, 0.3089910, 0.0721245, 0.1649611,  1574,   570,   5094,   7903,  12997
210362,30067, 0.0000000, 0.0709698, 0.0134608,     0,   221,  13304,   3114,  16418
210363,21107, 0.0000000, 0.0309680, 0.0259428,     0,   302,   1889,   9752,  11641
210363,30067, 0.0000000, 0.2729608, 0.0517724,     0,   850,  13304,   3114,  16418
210364,21107, 0.0000000, 0.1038761, 0.0870200,     0,  1013,   1889,   9752,  11641
210365,30050, 0.3072115, 0.1798447, 0.2140460,  1278,  2038,   4160,  11332,  15492
211336,22001, 0.0000000, 0.0000550, 0.0000482,     0,     3,   7698,  54499,  62197
211337,22001, 0.0000000, 0.0015597, 0.0013666,     0,    85,   7698,  54499,  62197
211338,22001, 0.0000000, 0.0008808, 0.0007717,     0,    48,   7698,  54499,  62197
211339,22016, 0.0000000, 0.0010511, 0.0002772,     0,    67, 177956,  63743, 241699
211340,22016, 0.0000000, 0.0042201, 0.0011130,     0,   269, 177956,  63743, 241699
211341,15003, 0.0000000, 0.0285241, 0.0249649,     0,  1119,   5593,  39230,  44823
211342,22016, 0.0000000, 0.0021336, 0.0005627,     0,   136, 177956,  63743, 241699
211343,15071, 0.0000000, 0.0642229, 0.0499923,     0,   650,   2881,  10121,  13002
211343,22016, 0.0000000, 0.0010354, 0.0002731,     0,    66, 177956,  63743, 241699
211345,15071, 0.0000000, 0.2357475, 0.1835102,     0,  2386,   2881,  10121,  13002
211346,15071, 0.0000000, 0.0608636, 0.0473773,     0,   616,   2881,  10121,  13002
211347,15071, 0.0357515, 0.0804268, 0.0705276,   103,   814,   2881,  10121,  13002
211347,13044, 0.0000000, 0.0007534, 0.0007022,     0,    11,   1065,  14601,  15666
211348,13044, 0.0000000, 0.0823916, 0.0767905,     0,  1203,   1065,  14601,  15666
211348,15071, 0.0000000, 0.0005928, 0.0004615,     0,     6,   2881,  10121,  13002
211349,13044, 0.0000000, 0.0363674, 0.0338951,     0,   531,   1065,  14601,  15666
211350,13044, 0.0000000, 0.0343812, 0.0320439,     0,   502,   1065,  14601,  15666
211351,13044, 0.0000000, 0.0219163, 0.0204264,     0,   320,   1065,  14601,  15666
211352,13044, 0.0000000, 0.0284912, 0.0265543,     0,   416,   1065,  14601,  15666
211353,13044, 1.0000000, 0.0362989, 0.1018128,  1065,   530,   1065,  14601,  15666
211354,13044, 0.0000000, 0.1225943, 0.1142602,     0,  1790,   1065,  14601,  15666
211355,13044, 0.0000000, 0.0024656, 0.0022980,     0,    36,   1065,  14601,  15666
211355,13017, 0.0000000, 0.0370015, 0.0314563,     0,   386,   1839,  10432,  12271
211356,13017, 0.0000000, 0.1884586, 0.1602151,     0,  1966,   1839,  10432,  12271
211360,13017, 0.0000000, 0.0707439, 0.0601418,     0,   738,   1839,  10432,  12271
211361,13064, 0.0000000, 0.1178603, 0.1079477,     0,  1073,    836,   9104,   9940
211362,13064, 0.0000000, 0.0430580, 0.0394366,     0,   392,    836,   9104,   9940
211365,13067, 0.0000000, 0.0859705, 0.0279438,     0,  1342,  32415,  15610,  48025
211365,13041, 0.0000000, 0.1071723, 0.0364197,     0,  1560,  28278,  14556,  42834
211367,13067, 0.0000000, 0.1218450, 0.0396044,     0,  1902,  32415,  15610,  48025
211367,13019, 0.0000000, 0.1478293, 0.1378757,     0,  2404,   1174,  16262,  17436
211368,13019, 0.0000000, 0.0003690, 0.0003441,     0,     6,   1174,  16262,  17436
211369,13041, 0.0018742, 0.0013740, 0.0017043,    53,    20,  28278,  14556,  42834
211369,13050, 0.6045980, 0.0027478, 0.4764370, 10572,    13,  17486,   4731,  22217
211370,13041, 0.0000000, 0.1627508, 0.0553065,     0,  2369,  28278,  14556,  42834
211371,13023, 0.0000000, 0.0823811, 0.0304121,     0,  1031,  21386,  12515,  33901
211371,13041, 0.0000000, 0.0018549, 0.0006303,     0,    27,  28278,  14556,  42834
211372,13023, 0.3438231, 0.1747503, 0.2814076,  7353,  2187,  21386,  12515,  33901
211373,13023, 0.0072010, 0.1920895, 0.0754550,   154,  2404,  21386,  12515,  33901
211374,13023, 0.0755167, 0.0580903, 0.0690835,  1615,   727,  21386,  12515,  33901
211375,13054, 0.0727086, 0.1445792, 0.1296494,   495,  3754,   6808,  25965,  32773
211376,13054, 0.0011751, 0.0520701, 0.0414976,     8,  1352,   6808,  25965,  32773
211376,13003, 0.0254226, 0.0108669, 0.0210317,   964,   178,  37919,  16380,  54299
211377,13003, 0.0451752, 0.0444444, 0.0449548,  1713,   728,  37919,  16380,  54299
211378,13009, 0.4381180, 0.0485423, 0.1143087,  1285,   701,   2933,  14441,  17374
211379,13009, 0.3753836, 0.0138495, 0.0748820,  1101,   200,   2933,  14441,  17374
211381,13009, 0.0000000, 0.0443875, 0.0368942,     0,   641,   2933,  14441,  17374
211382,13038, 0.0000000, 0.0529404, 0.0497494,     0,   397,    481,   7499,   7980
211383,13038, 0.0000000, 0.0404054, 0.0379699,     0,   303,    481,   7499,   7980
211384,13038, 0.0187110, 0.0425390, 0.0411028,     9,   319,    481,   7499,   7980
211385,13038, 0.5945946, 0.0196026, 0.0542606,   286,   147,    481,   7499,   7980
211386,13038, 0.0000000, 0.2098947, 0.1972431,     0,  1574,    481,   7499,   7980
211387,13038, 0.0000000, 0.0126684, 0.0119048,     0,    95,    481,   7499,   7980
211387,13045, 0.0000000, 0.0194371, 0.0171817,     0,   154,   1040,   7923,   8963
211388,13045, 0.0000000, 0.1051369, 0.0929376,     0,   833,   1040,   7923,   8963
211389,13024, 0.0000000, 0.0579188, 0.0561052,     0,   964,    538,  16644,  17182
211390,13024, 0.0018587, 0.0820716, 0.0795600,     1,  1366,    538,  16644,  17182
211391,13024, 0.0000000, 0.0749219, 0.0725759,     0,  1247,    538,  16644,  17182
211392,13024, 0.0000000, 0.0225306, 0.0218252,     0,   375,    538,  16644,  17182
211393,13024, 0.0000000, 0.0713771, 0.0691421,     0,  1188,    538,  16644,  17182
211394,13001, 0.0000000, 0.0595771, 0.0583753,     0,  1172,    405,  19672,  20077
211395,13001, 0.0000000, 0.0003050, 0.0002988,     0,     6,    405,  19672,  20077
211396,13001, 0.0000000, 0.0135726, 0.0132988,     0,   267,    405,  19672,  20077
211398,13035, 0.0000000, 0.0933719, 0.0762971,     0,   872,   2090,   9339,  11429
211399,13035, 0.0000000, 0.0057822, 0.0047248,     0,    54,   2090,   9339,  11429
211400,13035, 0.0000000, 0.0958347, 0.0783096,     0,   895,   2090,   9339,  11429
211401,13002, 0.0000000, 0.0129749, 0.0075647,     0,   307,  16922,  23661,  40583
211402,13002, 0.0000000, 0.0556612, 0.0324520,     0,  1317,  16922,  23661,  40583
211403,13002, 0.0390025, 0.0084105, 0.0211665,   660,   199,  16922,  23661,  40583
211404,13002, 0.0000000, 0.0071426, 0.0041643,     0,   169,  16922,  23661,  40583
211405,21100, 0.0000000, 0.1422156, 0.1174410,     0,  1140,   1691,   8016,   9707
211406,21100, 0.2052040, 0.2743264, 0.2622850,   347,  2199,   1691,   8016,   9707
211407,21071, 0.0000000, 0.0703797, 0.0201017,     0,  1965,  69833,  27920,  97753
211407,21100, 0.0000000, 0.0012475, 0.0010302,     0,    10,   1691,   8016,   9707
211408,21071, 0.0000000, 0.0232808, 0.0066494,     0,   650,  69833,  27920,  97753
211409,21071, 0.0000000, 0.0935172, 0.0267102,     0,  2611,  69833,  27920,  97753
211409,21091, 0.0710716, 0.3572139, 0.1273867,   583,   718,   8203,   2010,  10213
211410,21071, 0.0295992, 0.0381805, 0.0320502,  2067,  1066,  69833,  27920,  97753
211410,21091, 0.9289284, 0.1373134, 0.7731323,  7620,   276,   8203,   2010,  10213
211411,21091, 0.0000000, 0.0328358, 0.0064624,     0,    66,   8203,   2010,  10213
211411,21071, 0.0825255, 0.0033309, 0.0599061,  5763,    93,  69833,  27920,  97753
211412,21183, 0.0000000, 0.0729231, 0.0355089,     0,   704,  10172,   9654,  19826
211413,21183, 0.0290995, 0.0075616, 0.0186119,   296,    73,  10172,   9654,  19826
211413,21213, 0.0000000, 0.0821497, 0.0747805,     0,   937,   1124,  11406,  12530
211415,21089, 0.0000000, 0.0380868, 0.0231592,     0,   301,   5094,   7903,  12997
211416,21089, 0.0000000, 0.0217639, 0.0132338,     0,   172,   5094,   7903,  12997
211420,30067, 1.0000000, 0.0523443, 0.8202583, 13304,   163,  13304,   3114,  16418
211421,30103, 0.9417101, 0.1596499, 0.5027947,  4879,  1058,   5181,   6627,  11808
211422,30103, 0.0000000, 0.0983854, 0.0552168,     0,   652,   5181,   6627,  11808
211423,30103, 0.0000000, 0.4459031, 0.2502541,     0,  2955,   5181,   6627,  11808
211424,30103, 0.0000000, 0.0769579, 0.0431911,     0,   510,   5181,   6627,  11808
211424,30064, 1.0000000, 0.0124711, 0.4502443,  1724,    27,   1724,   2165,   3889
212394,22001, 0.0000000, 0.0057065, 0.0050002,     0,   311,   7698,  54499,  62197
212395,22001, 0.0000000, 0.0060185, 0.0052736,     0,   328,   7698,  54499,  62197
212396,22001, 0.0000000, 0.0144773, 0.0126855,     0,   789,   7698,  54499,  62197
212397,22016, 0.0000000, 0.0075459, 0.0019901,     0,   481, 177956,  63743, 241699
212398,22016, 0.0000000, 0.0001255, 0.0000331,     0,     8, 177956,  63743, 241699
212399,22016, 0.0000000, 0.0062909, 0.0016591,     0,   401, 177956,  63743, 241699
212401,22016, 0.0000000, 0.0002039, 0.0000538,     0,    13, 177956,  63743, 241699
212402,22016, 0.0000000, 0.0481465, 0.0126976,     0,  3069, 177956,  63743, 241699
212403,15071, 0.0000000, 0.0240095, 0.0186894,     0,   243,   2881,  10121,  13002
212405,15071, 0.0000000, 0.0265784, 0.0206891,     0,   269,   2881,  10121,  13002
212405,13029, 0.0000000, 0.0001762, 0.0001130,     0,     5,  15882,  28371,  44253
212406,13044, 0.0000000, 0.0021916, 0.0020426,     0,    32,   1065,  14601,  15666
212407,13044, 0.0000000, 0.0115745, 0.0107877,     0,   169,   1065,  14601,  15666
212408,13044, 0.0000000, 0.0009588, 0.0008937,     0,    14,   1065,  14601,  15666
212410,13044, 0.0000000, 0.1475926, 0.1375590,     0,  2155,   1065,  14601,  15666
212411,13044, 0.0000000, 0.0011643, 0.0010852,     0,    17,   1065,  14601,  15666
212412,13044, 0.0000000, 0.0139716, 0.0130218,     0,   204,   1065,  14601,  15666
212413,13044, 0.0000000, 0.0256832, 0.0239372,     0,   375,   1065,  14601,  15666
212414,13017, 0.0000000, 0.0068060, 0.0057860,     0,    71,   1839,  10432,  12271
212414,13044, 0.0000000, 0.0056845, 0.0052981,     0,    83,   1065,  14601,  15666
212415,13017, 0.0000000, 0.0243482, 0.0206992,     0,   254,   1839,  10432,  12271
212416,13017, 0.0000000, 0.0008627, 0.0007334,     0,     9,   1839,  10432,  12271
212417,13017, 0.0000000, 0.0188842, 0.0160541,     0,   197,   1839,  10432,  12271
212418,13017, 0.0000000, 0.1396664, 0.1187352,     0,  1457,   1839,  10432,  12271
212419,13017, 0.0000000, 0.0187883, 0.0159726,     0,   196,   1839,  10432,  12271
212420,13017, 0.1435563, 0.0008627, 0.0222476,   264,     9,   1839,  10432,  12271
212425,13019, 0.0000000, 0.0959292, 0.0894701,     0,  1560,   1174,  16262,  17436
212426,13019, 0.0000000, 0.1052146, 0.0981303,     0,  1711,   1174,  16262,  17436
212428,13050, 0.3290632, 0.0369901, 0.2668677,  5754,   175,  17486,   4731,  22217
212429,13050, 0.0000000, 0.0008455, 0.0001800,     0,     4,  17486,   4731,  22217
212429,13041, 0.0000000, 0.2229321, 0.0757576,     0,  3245,  28278,  14556,  42834
212430,13023, 0.0000000, 0.1881742, 0.0694670,     0,  2355,  21386,  12515,  33901
212431,13023, 0.1729636, 0.1529365, 0.1655703,  3699,  1914,  21386,  12515,  33901
212432,13023, 0.0020107, 0.0180583, 0.0079349,    43,   226,  21386,  12515,  33901
212432,13054, 0.0000000, 0.0234161, 0.0185519,     0,   608,   6808,  25965,  32773
212433,13023, 0.0591508, 0.0077507, 0.0401758,  1265,    97,  21386,  12515,  33901
212433,13054, 0.0000000, 0.0436742, 0.0346017,     0,  1134,   6808,  25965,  32773
212434,13054, 0.2890717, 0.0585403, 0.1064291,  1968,  1520,   6808,  25965,  32773
212435,13003, 0.0754503, 0.0276557, 0.0610324,  2861,   453,  37919,  16380,  54299
212436,13003, 0.3796514, 0.0289377, 0.2738540, 14396,   474,  37919,  16380,  54299
212437,13009, 0.0000000, 0.2274081, 0.1890181,     0,  3284,   2933,  14441,  17374
212437,13003, 0.0491310, 0.1125763, 0.0682701,  1863,  1844,  37919,  16380,  54299
212438,13009, 0.0000000, 0.0049858, 0.0041441,     0,    72,   2933,  14441,  17374
212439,13009, 0.0000000, 0.0269372, 0.0223898,     0,   389,   2933,  14441,  17374
212440,13003, 0.0000000, 0.0437118, 0.0131862,     0,   716,  37919,  16380,  54299
212441,13038, 0.0000000, 0.0132018, 0.0124060,     0,    99,    481,   7499,   7980
212442,13038, 0.0000000, 0.0424057, 0.0398496,     0,   318,    481,   7499,   7980
212444,13012, 0.0000000, 0.0090452, 0.0066073,     0,   178,   7261,  19679,  26940
212445,13038, 0.0000000, 0.0165355, 0.0155388,     0,   124,    481,   7499,   7980
212446,13012, 0.0000000, 0.0224605, 0.0164068,     0,   442,   7261,  19679,  26940
212447,13045, 0.0000000, 0.0316799, 0.0280040,     0,   251,   1040,   7923,   8963
212447,13012, 0.0000000, 0.0511713, 0.0373794,     0,  1007,   7261,  19679,  26940
212447,13024, 0.0000000, 0.0486061, 0.0470842,     0,   809,    538,  16644,  17182
212448,13024, 0.0000000, 0.0304013, 0.0294494,     0,   506,    538,  16644,  17182
212449,13024, 0.0000000, 0.0067892, 0.0065766,     0,   113,    538,  16644,  17182
212450,13024, 0.0000000, 0.0417568, 0.0404493,     0,   695,    538,  16644,  17182
212451,13024, 0.0000000, 0.0198870, 0.0192643,     0,   331,    538,  16644,  17182
212452,13024, 0.0000000, 0.0244533, 0.0236876,     0,   407,    538,  16644,  17182
212453,13001, 0.0000000, 0.0413278, 0.0404941,     0,   813,    405,  19672,  20077
212454,13001, 0.0000000, 0.0157076, 0.0153907,     0,   309,    405,  19672,  20077
212455,13035, 0.0000000, 0.0010708, 0.0008750,     0,    10,   2090,   9339,  11429
212455,13001, 0.0000000, 0.0095059, 0.0093141,     0,   187,    405,  19672,  20077
212456,13035, 0.0000000, 0.0481850, 0.0393735,     0,   450,   2090,   9339,  11429
212457,13035, 0.0000000, 0.0562159, 0.0459358,     0,   525,   2090,   9339,  11429
212458,13035, 1.0000000, 0.0275190, 0.2053548,  2090,   257,   2090,   9339,  11429
212459,13035, 0.0000000, 0.0975479, 0.0797095,     0,   911,   2090,   9339,  11429
212459,21057, 0.0000000, 0.2476311, 0.2101032,     0,  1568,   1131,   6332,   7463
212460,21057, 0.0000000, 0.2465256, 0.2091652,     0,  1561,   1131,   6332,   7463
212461,21057, 0.0415561, 0.1146557, 0.1035777,    47,   726,   1131,   6332,   7463
212462,13002, 0.0000000, 0.0024513, 0.0014292,     0,    58,  16922,  23661,  40583
212462,21057, 0.9584439, 0.0912824, 0.2226987,  1084,   578,   1131,   6332,   7463
212463,13002, 0.0000000, 0.0535480, 0.0312200,     0,  1267,  16922,  23661,  40583
212465,21100, 0.7794204, 0.1860030, 0.2893788,  1318,  1491,   1691,   8016,   9707
212467,21071, 0.0000000, 0.0151862, 0.0043375,     0,   424,  69833,  27920,  97753
212468,21071, 0.0000000, 0.0277221, 0.0079179,     0,   774,  69833,  27920,  97753
212469,21091, 0.0000000, 0.4567164, 0.0898854,     0,   918,   8203,   2010,  10213
212470,21091, 0.0000000, 0.0159204, 0.0031333,     0,    32,   8203,   2010,  10213
212470,21197, 0.0092007, 0.0790954, 0.0341794,   447,  2137,  48583,  27018,  75601
212471,21213, 0.0000000, 0.0980186, 0.0892259,     0,  1118,   1124,  11406,  12530
212471,21197, 0.0000000, 0.0581094, 0.0207669,     0,  1570,  48583,  27018,  75601
212472,21213, 0.0000000, 0.0821497, 0.0747805,     0,   937,   1124,  11406,  12530
212472,21197, 0.0000000, 0.0079577, 0.0028439,     0,   215,  48583,  27018,  75601
212473,21213, 0.0000000, 0.0499737, 0.0454908,     0,   570,   1124,  11406,  12530
212474,21089, 0.0000000, 0.1571555, 0.0955605,     0,  1242,   5094,   7903,  12997
212474,21183, 0.0000000, 0.0234100, 0.0113992,     0,   226,  10172,   9654,  19826
212474,21213, 0.0000000, 0.0650535, 0.0592179,     0,   742,   1124,  11406,  12530
212475,21089, 0.6073812, 0.0706061, 0.2809879,  3094,   558,   5094,   7903,  12997
212476,21089, 0.0000000, 0.1270404, 0.0772486,     0,  1004,   5094,   7903,  12997
212479,30067, 0.0000000, 0.1631342, 0.0309417,     0,   508,  13304,   3114,  16418
212480,30103, 0.0582899, 0.0599064, 0.0591972,   302,   397,   5181,   6627,  11808
212480,30067, 0.0000000, 0.4177906, 0.0792423,     0,  1301,  13304,   3114,  16418
212481,30103, 0.0000000, 0.0940094, 0.0527608,     0,   623,   5181,   6627,  11808
212482,30051, 0.0000000, 0.0689835, 0.0423884,     0,   925,   8413,  13409,  21822
212483,30064, 0.0000000, 0.7454965, 0.4150167,     0,  1614,   1724,   2165,   3889
213453,22001, 0.0000000, 0.0078167, 0.0068492,     0,   426,   7698,  54499,  62197
213454,22001, 0.0000000, 0.0040184, 0.0035211,     0,   219,   7698,  54499,  62197
213455,22016, 0.0000000, 0.0051143, 0.0013488,     0,   326, 177956,  63743, 241699
213455,22001, 0.0000000, 0.0014129, 0.0012380,     0,    77,   7698,  54499,  62197
213456,22016, 0.0000000, 0.0106522, 0.0028093,     0,   679, 177956,  63743, 241699
213457,22016, 0.0000000, 0.0176176, 0.0046463,     0,  1123, 177956,  63743, 241699
213458,22016, 0.0000000, 0.0024787, 0.0006537,     0,   158, 177956,  63743, 241699
213459,22016, 0.0000000, 0.0012550, 0.0003310,     0,    80, 177956,  63743, 241699
213460,22016, 0.0000000, 0.0325840, 0.0085933,     0,  2077, 177956,  63743, 241699
213461,22016, 0.0000000, 0.0383885, 0.0101242,     0,  2447, 177956,  63743, 241699
213462,22016, 0.0000000, 0.0002510, 0.0000662,     0,    16, 177956,  63743, 241699
213463,22016, 0.0191115, 0.0009413, 0.0143195,  3401,    60, 177956,  63743, 241699
213464,13029, 0.0000000, 0.0000352, 0.0000226,     0,     1,  15882,  28371,  44253
213465,13044, 0.0000000, 0.0007534, 0.0007022,     0,    11,   1065,  14601,  15666
213465,13029, 0.0000000, 0.0311586, 0.0199760,     0,   884,  15882,  28371,  44253
213466,13044, 0.0000000, 0.0041778, 0.0038938,     0,    61,   1065,  14601,  15666
213466,13029, 0.0000000, 0.0046879, 0.0030054,     0,   133,  15882,  28371,  44253
213467,13029, 0.0000000, 0.0777907, 0.0498723,     0,  2207,  15882,  28371,  44253
213468,13029, 0.0000000, 0.0023616, 0.0015140,     0,    67,  15882,  28371,  44253
213469,13029, 0.0000000, 0.0030313, 0.0019434,     0,    86,  15882,  28371,  44253
213474,13017, 0.0000000, 0.0026840, 0.0022818,     0,    28,   1839,  10432,  12271
213474,13029, 0.0000000, 0.0165662, 0.0106207,     0,   470,  15882,  28371,  44253
213477,13017, 0.0000000, 0.0334548, 0.0284410,     0,   349,   1839,  10432,  12271
213478,13017, 0.0565525, 0.0248275, 0.0295819,   104,   259,   1839,  10432,  12271
213479,13017, 0.7998912, 0.0735238, 0.1823812,  1471,   767,   1839,  10432,  12271
213480,13017, 0.0000000, 0.0005752, 0.0004890,     0,     6,   1839,  10432,  12271
213485,13019, 0.0000000, 0.0001845, 0.0001721,     0,     3,   1174,  16262,  17436
213487,13050, 0.0000000, 0.8361868, 0.1780618,     0,  3956,  17486,   4731,  22217
213488,13041, 0.0000000, 0.0615554, 0.0209180,     0,   896,  28278,  14556,  42834
213490,13023, 0.0000000, 0.0135038, 0.0049851,     0,   169,  21386,  12515,  33901
213491,13054, 0.0000000, 0.0358945, 0.0284380,     0,   932,   6808,  25965,  32773
213492,13054, 0.0171857, 0.0678606, 0.0573338,   117,  1762,   6808,  25965,  32773
213493,13054, 0.2159224, 0.0567302, 0.0897995,  1470,  1473,   6808,  25965,  32773
213494,13003, 0.0000000, 0.1412088, 0.0425975,     0,  2313,  37919,  16380,  54299
213494,13054, 0.0302585, 0.0001541, 0.0064077,   206,     4,   6808,  25965,  32773
213496,13003, 0.0602073, 0.0014652, 0.0424870,  2283,    24,  37919,  16380,  54299
213497,13009, 0.0000000, 0.0868361, 0.0721768,     0,  1254,   2933,  14441,  17374
213497,13003, 0.0000000, 0.0326618, 0.0098529,     0,   535,  37919,  16380,  54299
213498,13003, 0.0000000, 0.0208181, 0.0062800,     0,   341,  37919,  16380,  54299
213499,13003, 0.0000000, 0.0056166, 0.0016943,     0,    92,  37919,  16380,  54299
213500,13003, 0.0000000, 0.0025031, 0.0007551,     0,    41,  37919,  16380,  54299
213503,13038, 0.0000000, 0.0140019, 0.0131579,     0,   105,    481,   7499,   7980
213503,13012, 0.0000000, 0.0052848, 0.0038604,     0,   104,   7261,  19679,  26940
213504,13012, 0.0389753, 0.0025408, 0.0123608,   283,    50,   7261,  19679,  26940
213505,13012, 0.8931277, 0.0677880, 0.2902376,  6485,  1334,   7261,  19679,  26940
213507,13024, 0.0000000, 0.0201274, 0.0194971,     0,   335,    538,  16644,  17182
213507,13012, 0.0000000, 0.0464963, 0.0339644,     0,   915,   7261,  19679,  26940
213508,13024, 0.0000000, 0.0247537, 0.0239786,     0,   412,    538,  16644,  17182
213510,13024, 0.0000000, 0.0115958, 0.0112327,     0,   193,    538,  16644,  17182
213511,13001, 0.0000000, 0.0114376, 0.0112069,     0,   225,    405,  19672,  20077
213511,13024, 0.0000000, 0.0009012, 0.0008730,     0,    15,    538,  16644,  17182
213512,13001, 0.0000000, 0.0128101, 0.0125517,     0,   252,    405,  19672,  20077
213513,13001, 0.0000000, 0.0231293, 0.0226627,     0,   455,    405,  19672,  20077
213514,13001, 0.0000000, 0.0005592, 0.0005479,     0,    11,    405,  19672,  20077
213514,13035, 0.0000000, 0.0139201, 0.0113746,     0,   130,   2090,   9339,  11429
213515,13035, 0.0000000, 0.0546097, 0.0446233,     0,   510,   2090,   9339,  11429
213516,13035, 0.0000000, 0.2372845, 0.1938927,     0,  2216,   2090,   9339,  11429
213517,13035, 0.0000000, 0.0251633, 0.0205617,     0,   235,   2090,   9339,  11429
213518,13035, 0.0000000, 0.0353357, 0.0288739,     0,   330,   2090,   9339,  11429
213518,13060, 0.0000000, 0.0592297, 0.0508544,     0,   875,   2433,  14773,  17206
213519,21057, 0.0000000, 0.0440619, 0.0373844,     0,   279,   1131,   6332,   7463
213521,21109, 0.0000000, 0.0161673, 0.0109128,     0,   225,   6701,  13917,  20618
213521,21057, 0.0000000, 0.2558433, 0.2170709,     0,  1620,   1131,   6332,   7463
213522,21109, 0.0158185, 0.0320471, 0.0267727,   106,   446,   6701,  13917,  20618
213523,21109, 0.4599313, 0.2125458, 0.2929479,  3082,  2958,   6701,  13917,  20618
213524,21109, 0.0000000, 0.2469641, 0.1666990,     0,  3437,   6701,  13917,  20618
213525,21100, 0.0000000, 0.2630988, 0.2172659,     0,  2109,   1691,   8016,   9707
213526,21071, 0.0000000, 0.0088109, 0.0025165,     0,   246,  69833,  27920,  97753
213527,21071, 0.0000000, 0.0116762, 0.0033349,     0,   326,  69833,  27920,  97753
213528,21197, 0.0000000, 0.0838330, 0.0299599,     0,  2265,  48583,  27018,  75601
213529,21197, 0.3541980, 0.0229477, 0.2358170, 17208,   620,  48583,  27018,  75601
213530,21197, 0.0743264, 0.1445703, 0.0994299,  3611,  3906,  48583,  27018,  75601
213532,21213, 1.0000000, 0.1787656, 0.2524341,  1124,  2039,   1124,  11406,  12530
213532,21197, 0.0000000, 0.0773188, 0.0276319,     0,  2089,  48583,  27018,  75601
213533,21089, 0.0000000, 0.1341263, 0.0815573,     0,  1060,   5094,   7903,  12997
213533,21213, 0.0000000, 0.0092057, 0.0083799,     0,   105,   1124,  11406,  12530
213534,21089, 0.0414213, 0.0594711, 0.0523967,   211,   470,   5094,   7903,  12997
213534,21213, 0.0000000, 0.0033316, 0.0030327,     0,    38,   1124,  11406,  12530
213535,21213, 0.0000000, 0.0184114, 0.0167598,     0,   210,   1124,  11406,  12530
213536,21089, 0.0000000, 0.0226496, 0.0137724,     0,   179,   5094,   7903,  12997
213537,21089, 0.0000000, 0.0003796, 0.0002308,     0,     3,   5094,   7903,  12997
213537,30037, 0.5597081, 0.0018257, 0.4032010,  3145,     4,   5619,   2191,   7810
213539,30067, 0.0000000, 0.0228003, 0.0043245,     0,    71,  13304,   3114,  16418
213539,30051, 0.0337573, 0.0008949, 0.0135643,   284,    12,   8413,  13409,  21822
213540,30103, 0.0000000, 0.0651879, 0.0365854,     0,   432,   5181,   6627,  11808
213540,30051, 0.9645786, 0.0003729, 0.3721015,  8115,     5,   8413,  13409,  21822
213540,30037, 0.0000000, 0.0018257, 0.0005122,     0,     4,   5619,   2191,   7810
213541,30051, 0.0000000, 0.1367738, 0.0840436,     0,  1834,   8413,  13409,  21822
213542,30051, 0.0000000, 0.0029085, 0.0017872,     0,    39,   8413,  13409,  21822
214513,22001, 0.0000000, 0.0047157, 0.0041320,     0,   257,   7698,  54499,  62197
214513,22016, 0.0000000, 0.0103698, 0.0027348,     0,   661, 177956,  63743, 241699
214514,22016, 0.0000000, 0.0120954, 0.0031899,     0,   771, 177956,  63743, 241699
214515,22016, 0.0000000, 0.0072165, 0.0019032,     0,   460, 177956,  63743, 241699
214516,22016, 0.0000000, 0.0321761, 0.0084858,     0,  2051, 177956,  63743, 241699
214517,22016, 0.0000000, 0.0226848, 0.0059826,     0,  1446, 177956,  63743, 241699
214518,22016, 0.0000000, 0.0098050, 0.0025859,     0,   625, 177956,  63743, 241699
214519,22016, 0.0000000, 0.0243635, 0.0064253,     0,  1553, 177956,  63743, 241699
214520,22016, 0.0190047, 0.0219161, 0.0197725,  3382,  1397, 177956,  63743, 241699
214521,22016, 0.0000506, 0.0044711, 0.0012164,     9,   285, 177956,  63743, 241699
214528,13029, 0.0130966, 0.0330972, 0.0259191,   208,   939,  15882,  28371,  44253
214529,13029, 0.1226546, 0.0006345, 0.0444264,  1948,    18,  15882,  28371,  44253
214530,13029, 0.0000000, 0.0569596, 0.0365173,     0,  1616,  15882,  28371,  44253
214532,13029, 0.0000000, 0.0184696, 0.0118410,     0,   524,  15882,  28371,  44253
214533,13029, 0.0000000, 0.0093405, 0.0059883,     0,   265,  15882,  28371,  44253
214537,13017, 0.0000000, 0.0147623, 0.0125499,     0,   154,   1839,  10432,  12271
214537,13006, 0.0000000, 0.0099010, 0.0091107,     0,   172,   1507,  17372,  18879
214538,13017, 0.0000000, 0.0006710, 0.0005705,     0,     7,   1839,  10432,  12271
214539,13017, 0.0000000, 0.0861771, 0.0732622,     0,   899,   1839,  10432,  12271
214539,13006, 0.0000000, 0.0360350, 0.0331585,     0,   626,   1507,  17372,  18879
214541,13006, 0.0000000, 0.0024177, 0.0022247,     0,    42,   1507,  17372,  18879
214543,13019, 0.0000000, 0.0008609, 0.0008029,     0,    14,   1174,  16262,  17436
214544,13019, 0.7708688, 0.0503628, 0.0988759,   905,   819,   1174,  16262,  17436
214545,13050, 0.0000000, 0.0469245, 0.0099923,     0,   222,  17486,   4731,  22217
214546,13050, 0.0000000, 0.0120482, 0.0025656,     0,    57,  17486,   4731,  22217
214547,13050, 0.0000000, 0.0139505, 0.0029707,     0,    66,  17486,   4731,  22217
214548,13041, 0.0000000, 0.0141522, 0.0048093,     0,   206,  28278,  14556,  42834
214551,13054, 0.0000000, 0.1475448, 0.1168950,     0,  3831,   6808,  25965,  32773
214552,13054, 0.1141304, 0.0737916, 0.0821713,   777,  1916,   6808,  25965,  32773
214554,13003, 0.0000000, 0.1710623, 0.0516032,     0,  2802,  37919,  16380,  54299
214556,13003, 0.0000000, 0.0818681, 0.0246966,     0,  1341,  37919,  16380,  54299
214559,13003, 0.0000000, 0.0026862, 0.0008103,     0,    44,  37919,  16380,  54299
214560,13012, 0.0000000, 0.0159561, 0.0116555,     0,   314,   7261,  19679,  26940
214561,13012, 0.0000000, 0.0135169, 0.0098738,     0,   266,   7261,  19679,  26940
214562,13012, 0.0000000, 0.0438539, 0.0320342,     0,   863,   7261,  19679,  26940
214563,13012, 0.0000000, 0.1398953, 0.1021901,     0,  2753,   7261,  19679,  26940
214565,13012, 0.0000000, 0.0617918, 0.0451373,     0,  1216,   7261,  19679,  26940
214566,13012, 0.0000000, 0.0168708, 0.0123237,     0,   332,   7261,  19679,  26940
214567,13024, 0.0000000, 0.0088921, 0.0086137,     0,   148,    538,  16644,  17182
214567,13012, 0.0000000, 0.0127547, 0.0093170,     0,   251,   7261,  19679,  26940
214568,13024, 0.0000000, 0.0150805, 0.0146083,     0,   251,    538,  16644,  17182
214569,13024, 0.0000000, 0.0004206, 0.0004074,     0,     7,    538,  16644,  17182
214570,13001, 0.0000000, 0.0163176, 0.0159884,     0,   321,    405,  19672,  20077
214571,13001, 0.0000000, 0.0136234, 0.0133486,     0,   268,    405,  19672,  20077
214573,13035, 0.0000000, 0.0269836, 0.0220492,     0,   252,   2090,   9339,  11429
214573,13001, 0.0000000, 0.0116409, 0.0114061,     0,   229,    405,  19672,  20077
214574,13035, 0.0000000, 0.0029982, 0.0024499,     0,    28,   2090,   9339,  11429
214575,13035, 0.0000000, 0.1349181, 0.1102459,     0,  1260,   2090,   9339,  11429
214575,13004, 0.0000000, 0.0452268, 0.0351345,     0,   316,   2007,   6987,   8994
214576,13035, 0.0000000, 0.0126352, 0.0103246,     0,   118,   2090,   9339,  11429
214577,13060, 0.0000000, 0.0063630, 0.0054632,     0,    94,   2433,  14773,  17206
214578,13060, 0.0000000, 0.0194950, 0.0167383,     0,   288,   2433,  14773,  17206
214579,13060, 0.0000000, 0.0838015, 0.0719516,     0,  1238,   2433,  14773,  17206
214581,21109, 0.4742576, 0.0712797, 0.2022505,  3178,   992,   6701,  13917,  20618
214582,21109, 0.0499925, 0.1953007, 0.1480745,   335,  2718,   6701,  13917,  20618
214583,21109, 0.0000000, 0.0641661, 0.0433117,     0,   893,   6701,  13917,  20618
214584,21100, 0.0000000, 0.0762226, 0.0629443,     0,   611,   1691,   8016,   9707
214585,21100, 0.0000000, 0.0450349, 0.0371897,     0,   361,   1691,   8016,   9707
214585,21178, 0.0000000, 0.0051847, 0.0046743,     0,    80,   1685,  15430,  17115
214586,21071, 0.0000000, 0.0523281, 0.0149458,     0,  1461,  69833,  27920,  97753
214587,21197, 0.0000000, 0.0009993, 0.0003571,     0,    27,  48583,  27018,  75601
214588,21197, 0.3080090, 0.0035902, 0.1992169, 14964,    97,  48583,  27018,  75601
214589,21197, 0.0735237, 0.0037012, 0.0485708,  3572,   100,  48583,  27018,  75601
214590,21197, 0.0000000, 0.0200977, 0.0071824,     0,   543,  48583,  27018,  75601
214591,21213, 0.0000000, 0.0016658, 0.0015164,     0,    19,   1124,  11406,  12530
214591,21197, 0.0000000, 0.0191354, 0.0068385,     0,   517,  48583,  27018,  75601
214592,21213, 0.0000000, 0.0017535, 0.0015962,     0,    20,   1124,  11406,  12530
214593,21213, 0.0000000, 0.0465544, 0.0423783,     0,   531,   1124,  11406,  12530
214594,21213, 0.0000000, 0.0257759, 0.0234637,     0,   294,   1124,  11406,  12530
214595,21213, 0.0000000, 0.0079783, 0.0072626,     0,    91,   1124,  11406,  12530
214595,21089, 0.0000000, 0.0035430, 0.0021543,     0,    28,   5094,   7903,  12997
214596,21213, 0.0000000, 0.0049097, 0.0044693,     0,    56,   1124,  11406,  12530
214597,30037, 0.4399359, 0.1506162, 0.3587708,  2472,   330,   5619,   2191,   7810
214598,30037, 0.0000000, 0.8439069, 0.2367478,     0,  1849,   5619,   2191,   7810
214599,30051, 0.0000000, 0.0460139, 0.0282742,     0,   617,   8413,  13409,  21822
214600,30051, 0.0000000, 0.0927735, 0.0570067,     0,  1244,   8413,  13409,  21822
214601,30066, 0.0000000, 0.0723052, 0.0723052,     0,  1414,      0,  19556,  19556
215572,22016, 0.0000000, 0.0342469, 0.0090319,     0,  2183, 177956,  63743, 241699
215573,22016, 0.0000000, 0.0141506, 0.0037319,     0,   902, 177956,  63743, 241699
215574,22016, 0.0000000, 0.0315799, 0.0083285,     0,  2013, 177956,  63743, 241699
215575,22016, 0.0000000, 0.0185903, 0.0049028,     0,  1185, 177956,  63743, 241699
215576,22016, 0.0019724, 0.0243791, 0.0078817,   351,  1554, 177956,  63743, 241699
215577,22016, 0.0189148, 0.0321447, 0.0224039,  3366,  2049, 177956,  63743, 241699
215578,22016, 0.0000000, 0.0280658, 0.0074018,     0,  1789, 177956,  63743, 241699
215579,22016, 0.0087494, 0.0019610, 0.0069591,  1557,   125, 177956,  63743, 241699
215582,13029, 0.0000000, 0.0039124, 0.0025083,     0,   111,  15882,  28371,  44253
215582,22016, 0.0000000, 0.0094128, 0.0024824,     0,   600, 177956,  63743, 241699
215584,13029, 0.0000000, 0.0156498, 0.0100332,     0,   444,  15882,  28371,  44253
215585,13029, 0.0000000, 0.0002467, 0.0001582,     0,     7,  15882,  28371,  44253
215586,13029, 0.0000000, 0.0535406, 0.0343254,     0,  1519,  15882,  28371,  44253
215587,13029, 0.0027075, 0.0001762, 0.0010847,    43,     5,  15882,  28371,  44253
215588,13029, 0.0868279, 0.0329914, 0.0523128,  1379,   936,  15882,  28371,  44253
215589,13029, 0.0564790, 0.0906912, 0.0784128,   897,  2573,  15882,  28371,  44253
215590,13029, 0.0000000, 0.0001410, 0.0000904,     0,     4,  15882,  28371,  44253
215592,13029, 0.0000000, 0.0063798, 0.0040901,     0,   181,  15882,  28371,  44253
215595,13006, 0.0000000, 0.0001727, 0.0001589,     0,     3,   1507,  17372,  18879
215596,13006, 0.0000000, 0.0265945, 0.0244716,     0,   462,   1507,  17372,  18879
215597,13006, 0.0000000, 0.0074833, 0.0068860,     0,   130,   1507,  17372,  18879
215599,13006, 0.0000000, 0.0186507, 0.0171619,     0,   324,   1507,  17372,  18879
215600,13006, 0.0000000, 0.0177297, 0.0163144,     0,   308,   1507,  17372,  18879
215602,13019, 0.0000000, 0.0144509, 0.0134779,     0,   235,   1174,  16262,  17436
215603,13019, 0.2257240, 0.0564506, 0.0678481,   265,   918,   1174,  16262,  17436
215604,13050, 0.0000000, 0.0503065, 0.0107125,     0,   238,  17486,   4731,  22217
215609,13054, 0.0000000, 0.0278067, 0.0220303,     0,   722,   6808,  25965,  32773
215610,13054, 0.0000000, 0.0614674, 0.0486986,     0,  1596,   6808,  25965,  32773
215611,13055, 0.0000000, 0.0946377, 0.0815536,     0,  1306,   2214,  13800,  16014
215612,13054, 0.0000000, 0.0013865, 0.0010985,     0,    36,   6808,  25965,  32773
215613,13055, 0.0000000, 0.0259420, 0.0223554,     0,   358,   2214,  13800,  16014
215613,13003, 0.0000000, 0.0817460, 0.0246598,     0,  1339,  37919,  16380,  54299
215614,13003, 0.0000000, 0.0153236, 0.0046226,     0,   251,  37919,  16380,  54299
215614,13055, 0.0000000, 0.0324638, 0.0279755,     0,   448,   2214,  13800,  16014
215615,13003, 0.0000000, 0.0180708, 0.0054513,     0,   296,  37919,  16380,  54299
215616,13003, 0.0000000, 0.0099512, 0.0030019,     0,   163,  37919,  16380,  54299
215618,13012, 0.0000000, 0.0106205, 0.0077580,     0,   209,   7261,  19679,  26940
215620,13012, 0.0000000, 0.0740383, 0.0540831,     0,  1457,   7261,  19679,  26940
215622,13012, 0.0000000, 0.0094009, 0.0068671,     0,   185,   7261,  19679,  26940
215623,13012, 0.0000000, 0.0672290, 0.0491091,     0,  1323,   7261,  19679,  26940
215624,13012, 0.0000000, 0.0263225, 0.0192279,     0,   518,   7261,  19679,  26940
215625,13012, 0.0000000, 0.0096041, 0.0070156,     0,   189,   7261,  19679,  26940
215626,13012, 0.0000000, 0.0048783, 0.0035635,     0,    96,   7261,  19679,  26940
215628,13024, 0.0000000, 0.0082312, 0.0079735,     0,   137,    538,  16644,  17182
215629,13024, 0.0000000, 0.0147200, 0.0142591,     0,   245,    538,  16644,  17182
215629,13001, 0.0000000, 0.0009658, 0.0009464,     0,    19,    405,  19672,  20077
215630,13001, 0.0000000, 0.0156568, 0.0153409,     0,   308,    405,  19672,  20077
215630,30072, 0.0000000, 0.0056577, 0.0042379,     0,    88,   5211,  15554,  20765
215631,13035, 0.0000000, 0.0014991, 0.0012250,     0,    14,   2090,   9339,  11429
215631,13004, 0.0000000, 0.0405038, 0.0314654,     0,   283,   2007,   6987,   8994
215632,13004, 0.0000000, 0.0878775, 0.0682677,     0,   614,   2007,   6987,   8994
215633,13004, 0.1205780, 0.1031916, 0.1070714,   242,   721,   2007,   6987,   8994
215634,13035, 0.0000000, 0.0291252, 0.0237991,     0,   272,   2090,   9339,  11429
215634,13004, 0.0164425, 0.0748533, 0.0618190,    33,   523,   2007,   6987,   8994
215637,13060, 0.0000000, 0.0251134, 0.0215622,     0,   371,   2433,  14773,  17206
215638,13060, 0.4155364, 0.1196101, 0.1614553,  1011,  1767,   2433,  14773,  17206
215639,13060, 0.0000000, 0.0926014, 0.0795071,     0,  1368,   2433,  14773,  17206
215640,21109, 0.0000000, 0.0090537, 0.0061112,     0,   126,   6701,  13917,  20618
215642,21109, 0.0000000, 0.0769562, 0.0519449,     0,  1071,   6701,  13917,  20618
215643,21109, 0.0000000, 0.0564777, 0.0381220,     0,   786,   6701,  13917,  20618
215644,21178, 0.1905044, 0.0445885, 0.0589541,   321,   688,   1685,  15430,  17115
215645,21197, 0.0000000, 0.0249463, 0.0089152,     0,   674,  48583,  27018,  75601
215646,21197, 0.0000000, 0.0030350, 0.0010846,     0,    82,  48583,  27018,  75601
215646,21178, 0.0000000, 0.0285807, 0.0257669,     0,   441,   1685,  15430,  17115
215647,21197, 0.0000000, 0.0005182, 0.0001852,     0,    14,  48583,  27018,  75601
215648,21197, 0.0000000, 0.0369013, 0.0131877,     0,   997,  48583,  27018,  75601
215649,21197, 0.0000000, 0.0295359, 0.0105554,     0,   798,  48583,  27018,  75601
215650,21197, 0.0000000, 0.0762825, 0.0272615,     0,  2061,  48583,  27018,  75601
215651,21213, 0.0000000, 0.0552341, 0.0502793,     0,   630,   1124,  11406,  12530
215651,21197, 0.0000000, 0.0001851, 0.0000661,     0,     5,  48583,  27018,  75601
215652,21213, 0.0000000, 0.0039453, 0.0035914,     0,    45,   1124,  11406,  12530
215653,21213, 0.0000000, 0.0543574, 0.0494812,     0,   620,   1124,  11406,  12530
215654,21213, 0.0000000, 0.0230580, 0.0209896,     0,   263,   1124,  11406,  12530
215655,21213, 0.0000000, 0.0142907, 0.0130088,     0,   163,   1124,  11406,  12530
215656,21213, 0.0000000, 0.0394529, 0.0359138,     0,   450,   1124,  11406,  12530
215657,30037, 0.0000000, 0.0018257, 0.0005122,     0,     4,   5619,   2191,   7810
215659,30051, 0.0000000, 0.0689835, 0.0423884,     0,   925,   8413,  13409,  21822
215660,30051, 0.0000000, 0.1278992, 0.0785904,     0,  1715,   8413,  13409,  21822
216630,22016, 0.0000000, 0.0112483, 0.0029665,     0,   717, 177956,  63743, 241699
216631,22016, 0.0000000, 0.0216337, 0.0057054,     0,  1379, 177956,  63743, 241699
216632,22016, 0.0158635, 0.0285365, 0.0192057,  2823,  1819, 177956,  63743, 241699
216633,22016, 0.0000000, 0.0336664, 0.0088788,     0,  2146, 177956,  63743, 241699
216634,22016, 0.0000000, 0.0049574, 0.0013074,     0,   316, 177956,  63743, 241699
216635,22016, 0.0354132, 0.0227790, 0.0320812,  6302,  1452, 177956,  63743, 241699
216638,22016, 0.0324631, 0.0055065, 0.0253538,  5777,   351, 177956,  63743, 241699
216639,22016, 0.0000000, 0.0749416, 0.0197643,     0,  4777, 177956,  63743, 241699
216641,13029, 0.0000000, 0.0119488, 0.0076605,     0,   339,  15882,  28371,  44253
216642,13029, 0.1949377, 0.0002467, 0.0701195,  3096,     7,  15882,  28371,  44253
216644,13029, 0.0000000, 0.0178351, 0.0114343,     0,   506,  15882,  28371,  44253
216646,13029, 0.0000000, 0.0342603, 0.0219646,     0,   972,  15882,  28371,  44253
216647,13029, 0.1210805, 0.0107504, 0.0503469,  1923,   305,  15882,  28371,  44253
216648,13029, 0.3910716, 0.0316168, 0.1606219,  6211,   897,  15882,  28371,  44253
216649,13029, 0.0000000, 0.0206196, 0.0132194,     0,   585,  15882,  28371,  44253
216650,13029, 0.0000000, 0.0210074, 0.0134680,     0,   596,  15882,  28371,  44253
216651,13029, 0.0000000, 0.0002467, 0.0001582,     0,     7,  15882,  28371,  44253
216656,13006, 0.0000000, 0.0264218, 0.0243127,     0,   459,   1507,  17372,  18879
216657,13006, 0.0000000, 0.0174419, 0.0160496,     0,   303,   1507,  17372,  18879
216658,13006, 0.0000000, 0.0672922, 0.0619207,     0,  1169,   1507,  17372,  18879
216659,13006, 0.0000000, 0.0041446, 0.0038138,     0,    72,   1507,  17372,  18879
216662,13019, 0.0000000, 0.0558357, 0.0520762,     0,   908,   1174,  16262,  17436
216663,13019, 0.0000000, 0.0533760, 0.0497821,     0,   868,   1174,  16262,  17436
216664,13019, 0.0000000, 0.1757471, 0.1639137,     0,  2858,   1174,  16262,  17436
216665,13054, 0.0000000, 0.0078182, 0.0061941,     0,   203,   6808,  25965,  32773
216668,13055, 0.0000000, 0.1269565, 0.1094043,     0,  1752,   2214,  13800,  16014
216669,13055, 0.0000000, 0.1073188, 0.0924816,     0,  1481,   2214,  13800,  16014
216670,13055, 0.0000000, 0.0526812, 0.0453978,     0,   727,   2214,  13800,  16014
216671,13055, 0.2615176, 0.0743478, 0.1002248,   579,  1026,   2214,  13800,  16014
216672,13055, 0.1255646, 0.0965217, 0.1005370,   278,  1332,   2214,  13800,  16014
216673,13055, 0.0000000, 0.0005797, 0.0004996,     0,     8,   2214,  13800,  16014
216674,13003, 0.0000000, 0.0136752, 0.0041253,     0,   224,  37919,  16380,  54299
216675,13003, 0.0000000, 0.0044567, 0.0013444,     0,    73,  37919,  16380,  54299
216676,13003, 0.0000000, 0.0040904, 0.0012339,     0,    67,  37919,  16380,  54299
216678,13012, 0.0000000, 0.0161594, 0.0118040,     0,   318,   7261,  19679,  26940
216679,13012, 0.0000000, 0.0174806, 0.0127691,     0,   344,   7261,  19679,  26940
216680,13012, 0.0000000, 0.0196656, 0.0143653,     0,   387,   7261,  19679,  26940
216681,13012, 0.0000000, 0.0289141, 0.0211210,     0,   569,   7261,  19679,  26940
216682,13012, 0.0000000, 0.0255602, 0.0186711,     0,   503,   7261,  19679,  26940
216685,13012, 0.0000000, 0.0022359, 0.0016333,     0,    44,   7261,  19679,  26940
216686,30072, 0.0000000, 0.0022502, 0.0016855,     0,    35,   5211,  15554,  20765
216687,30072, 0.0000000, 0.0133085, 0.0099687,     0,   207,   5211,  15554,  20765
216688,30072, 0.0000000, 0.0255883, 0.0191669,     0,   398,   5211,  15554,  20765
216690,13004, 0.0000000, 0.0621154, 0.0482544,     0,   434,   2007,   6987,   8994
216691,13004, 0.0000000, 0.1039073, 0.0807205,     0,   726,   2007,   6987,   8994
216692,13004, 0.5376183, 0.1338200, 0.2239271,  1079,   935,   2007,   6987,   8994
216693,13004, 0.3258595, 0.0206097, 0.0887258,   654,   144,   2007,   6987,   8994
216694,13053, 0.0000000, 0.0149656, 0.0128467,     0,   233,   2568,  15569,  18137
216695,13053, 0.0000000, 0.0024407, 0.0020952,     0,    38,   2568,  15569,  18137
216696,13060, 0.0000000, 0.0395993, 0.0339998,     0,   585,   2433,  14773,  17206
216697,13060, 0.5844636, 0.0626142, 0.1364059,  1422,   925,   2433,  14773,  17206
216698,13060, 0.0000000, 0.0844107, 0.0724747,     0,  1247,   2433,  14773,  17206
216699,13060, 0.0000000, 0.0994382, 0.0853772,     0,  1469,   2433,  14773,  17206
216700,13060, 0.0000000, 0.0008800, 0.0007556,     0,    13,   2433,  14773,  17206
216701,21109, 0.0000000, 0.0190415, 0.0128528,     0,   265,   6701,  13917,  20618
216701,21178, 0.0000000, 0.0349968, 0.0315513,     0,   540,   1685,  15430,  17115
216701,13060, 0.0000000, 0.0100860, 0.0086598,     0,   149,   2433,  14773,  17206
216702,21178, 0.0000000, 0.0187297, 0.0168858,     0,   289,   1685,  15430,  17115
216703,21178, 0.0000000, 0.0620220, 0.0559159,     0,   957,   1685,  15430,  17115
216704,21178, 0.0000000, 0.0191834, 0.0172948,     0,   296,   1685,  15430,  17115
216705,21178, 0.0000000, 0.0929358, 0.0837862,     0,  1434,   1685,  15430,  17115
216706,21197, 0.0000000, 0.0062181, 0.0022222,     0,   168,  48583,  27018,  75601
216706,21178, 0.0000000, 0.0425146, 0.0383289,     0,   656,   1685,  15430,  17115
216707,21197, 0.0000000, 0.0463025, 0.0165474,     0,  1251,  48583,  27018,  75601
216708,21197, 0.0000000, 0.0170257, 0.0060846,     0,   460,  48583,  27018,  75601
216709,21197, 0.0000000, 0.0201717, 0.0072089,     0,   545,  48583,  27018,  75601
216711,21213, 0.0000000, 0.0004384, 0.0003990,     0,     5,   1124,  11406,  12530
216711,21197, 0.0000000, 0.0010363, 0.0003704,     0,    28,  48583,  27018,  75601
216712,21213, 0.0000000, 0.0001753, 0.0001596,     0,     2,   1124,  11406,  12530
216713,21213, 0.0000000, 0.0318254, 0.0289705,     0,   363,   1124,  11406,  12530
216714,21213, 0.0000000, 0.0749605, 0.0682362,     0,   855,   1124,  11406,  12530
216716,30051, 0.0000000, 0.0169289, 0.0104023,     0,   227,   8413,  13409,  21822
216717,30051, 0.0000000, 0.0067119, 0.0041243,     0,    90,   8413,  13409,  21822
216718,30051, 0.0000000, 0.1011261, 0.0621391,     0,  1356,   8413,  13409,  21822
216719,30051, 0.0000000, 0.0670445, 0.0411970,     0,   899,   8413,  13409,  21822
217689,22012, 0.0000000, 0.0480874, 0.0103961,     0,   665,  50137,  13829,  63966
217690,22012, 0.0000000, 0.0002169, 0.0000469,     0,     3,  50137,  13829,  63966
217691,22016, 0.0221515, 0.0000628, 0.0163261,  3942,     4, 177956,  63743, 241699
217692,22016, 0.0299344, 0.0085343, 0.0242905,  5327,   544, 177956,  63743, 241699
217693,22016, 0.0037369, 0.0363805, 0.0123459,   665,  2319, 177956,  63743, 241699
217694,22016, 0.0325137, 0.0034670, 0.0248532,  5786,   221, 177956,  63743, 241699
217695,22016, 0.0827620, 0.0005805, 0.0610884, 14728,    37, 177956,  63743, 241699
217696,22016, 0.0520634, 0.0260421, 0.0452008,  9265,  1660, 177956,  63743, 241699
217697,22016, 0.0000000, 0.0005334, 0.0001407,     0,    34, 177956,  63743, 241699
217705,13029, 0.0000000, 0.0015509, 0.0009943,     0,    44,  15882,  28371,  44253
217706,13029, 0.0000000, 0.0660886, 0.0423700,     0,  1875,  15882,  28371,  44253
217707,13029, 0.0000000, 0.0175179, 0.0112309,     0,   497,  15882,  28371,  44253
217708,13029, 0.0000000, 0.0152973, 0.0098072,     0,   434,  15882,  28371,  44253
217709,13029, 0.0000000, 0.0093053, 0.0059657,     0,   264,  15882,  28371,  44253
217710,13029, 0.0000000, 0.0074724, 0.0047906,     0,   212,  15882,  28371,  44253
217711,13029, 0.0000000, 0.0003877, 0.0002486,     0,    11,  15882,  28371,  44253
217714,13006, 0.0000000, 0.0005181, 0.0004767,     0,     9,   1507,  17372,  18879
217716,13006, 0.0000000, 0.0383376, 0.0352773,     0,   666,   1507,  17372,  18879
217717,13006, 1.0000000, 0.1070113, 0.1782933,  1507,  1859,   1507,  17372,  18879
217718,13006, 0.0000000, 0.0790352, 0.0727263,     0,  1373,   1507,  17372,  18879
217719,13019, 0.0000000, 0.0064568, 0.0060220,     0,   105,   1174,  16262,  17436
217720,13019, 0.0000000, 0.0149428, 0.0139367,     0,   243,   1174,  16262,  17436
217721,13019, 0.0000000, 0.0940844, 0.0877495,     0,  1530,   1174,  16262,  17436
217722,13019, 0.0000000, 0.0806789, 0.0752466,     0,  1312,   1174,  16262,  17436
217723,13019, 0.0000000, 0.0472267, 0.0440468,     0,   768,   1174,  16262,  17436
217724,13054, 0.0000000, 0.0875794, 0.0693864,     0,  2274,   6808,  25965,  32773
217725,13054, 0.0000000, 0.0160601, 0.0127239,     0,   417,   6808,  25965,  32773
217726,13055, 0.0000000, 0.1802174, 0.1553016,     0,  2487,   2214,  13800,  16014
217726,13030, 0.0000000, 0.0612975, 0.0325371,     0,  2810,  40521,  45842,  86363
217729,13055, 0.0000000, 0.0362319, 0.0312227,     0,   500,   2214,  13800,  16014
217730,13055, 0.3992773, 0.0333333, 0.0839266,   884,   460,   2214,  13800,  16014
217731,13055, 0.2136405, 0.0006522, 0.0300987,   473,     9,   2214,  13800,  16014
217737,13012, 0.0000000, 0.0028457, 0.0020787,     0,    56,   7261,  19679,  26940
217738,13012, 0.0000000, 0.0252045, 0.0184113,     0,   496,   7261,  19679,  26940
217739,13012, 0.0000000, 0.0250013, 0.0182628,     0,   492,   7261,  19679,  26940
217741,13012, 0.0000000, 0.0076223, 0.0055679,     0,   150,   7261,  19679,  26940
217742,13012, 0.0000000, 0.0043701, 0.0031923,     0,    86,   7261,  19679,  26940
217743,13012, 0.0000000, 0.0064028, 0.0046771,     0,   126,   7261,  19679,  26940
217744,13012, 0.0000000, 0.0059962, 0.0043801,     0,   118,   7261,  19679,  26940
217745,30072, 0.0000000, 0.0068793, 0.0051529,     0,   107,   5211,  15554,  20765
217745,13012, 0.0000000, 0.0049291, 0.0036006,     0,    97,   7261,  19679,  26940
217746,30072, 0.0000000, 0.0251382, 0.0188298,     0,   391,   5211,  15554,  20765
217748,30072, 0.0000000, 0.0265527, 0.0198892,     0,   413,   5211,  15554,  20765
217749,30072, 0.0000000, 0.0004500, 0.0003371,     0,     7,   5211,  15554,  20765
217750,13004, 0.0000000, 0.0360670, 0.0280187,     0,   252,   2007,   6987,   8994
217750,30072, 0.0000000, 0.0263598, 0.0197448,     0,   410,   5211,  15554,  20765
217751,13004, 0.0000000, 0.1160727, 0.0901712,     0,   811,   2007,   6987,   8994
217752,13004, 0.0000000, 0.0699871, 0.0543696,     0,   489,   2007,   6987,   8994
217753,13053, 0.0000000, 0.0085426, 0.0073331,     0,   133,   2568,  15569,  18137
217753,13004, 0.0000000, 0.0452268, 0.0351345,     0,   316,   2007,   6987,   8994
217754,13053, 0.0000000, 0.0104053, 0.0089320,     0,   162,   2568,  15569,  18137
217755,13060, 0.0000000, 0.0131998, 0.0113333,     0,   195,   2433,  14773,  17206
217755,13053, 0.0000000, 0.0175348, 0.0150521,     0,   273,   2568,  15569,  18137
217756,13060, 0.0000000, 0.0379070, 0.0325468,     0,   560,   2433,  14773,  17206
217756,13053, 0.0000000, 0.0309590, 0.0265755,     0,   482,   2568,  15569,  18137
217757,13060, 0.0000000, 0.0946321, 0.0812507,     0,  1398,   2433,  14773,  17206
217757,13053, 0.0058411, 0.0277474, 0.0246458,    15,   432,   2568,  15569,  18137
217758,13060, 0.0000000, 0.0394639, 0.0338835,     0,   583,   2433,  14773,  17206
217759,13060, 0.0000000, 0.0639680, 0.0549227,     0,   945,   2433,  14773,  17206
217760,13060, 0.0000000, 0.0332363, 0.0285366,     0,   491,   2433,  14773,  17206
217760,21178, 0.0000000, 0.0158782, 0.0143149,     0,   245,   1685,  15430,  17115
217761,21178, 0.0000000, 0.0048607, 0.0043821,     0,    75,   1685,  15430,  17115
217761,21187, 0.0000000, 0.1902003, 0.1455217,     0,   788,   1272,   4143,   5415
217762,21187, 0.0000000, 0.2534395, 0.1939058,     0,  1050,   1272,   4143,   5415
217763,21178, 0.0000000, 0.0170447, 0.0153666,     0,   263,   1685,  15430,  17115
217764,21178, 0.0000000, 0.0129618, 0.0116857,     0,   200,   1685,  15430,  17115
217765,21178, 0.0000000, 0.0534025, 0.0481449,     0,   824,   1685,  15430,  17115
217766,21178, 0.0000000, 0.0760207, 0.0685364,     0,  1173,   1685,  15430,  17115
217767,21197, 0.0000000, 0.0259457, 0.0092724,     0,   701,  48583,  27018,  75601
217768,21197, 0.0618735, 0.0727663, 0.0657663,  3006,  1966,  48583,  27018,  75601
217769,21197, 0.0000000, 0.0235399, 0.0084126,     0,   636,  48583,  27018,  75601
217770,21197, 0.0000000, 0.0561848, 0.0200791,     0,  1518,  48583,  27018,  75601
217772,21213, 0.0000000, 0.0265650, 0.0241820,     0,   303,   1124,  11406,  12530
217773,30051, 0.0000000, 0.0478037, 0.0293740,     0,   641,   8413,  13409,  21822
217774,30051, 0.0000000, 0.0005966, 0.0003666,     0,     8,   8413,  13409,  21822
217775,30051, 0.0000000, 0.0014915, 0.0009165,     0,    20,   8413,  13409,  21822
217776,30051, 0.0000000, 0.0091729, 0.0056365,     0,   123,   8413,  13409,  21822
217777,30040, 0.0000000, 0.0494586, 0.0494586,     0,   708,      0,  14315,  14315
217778,30051, 0.0000000, 0.0007458, 0.0004583,     0,    10,   8413,  13409,  21822
217778,30040, 0.0000000, 0.0003493, 0.0003493,     0,     5,      0,  14315,  14315
218748,22012, 0.0857251, 0.0074481, 0.0688022,  4298,   103,  50137,  13829,  63966
218749,22012, 0.0000000, 0.0267554, 0.0057843,     0,   370,  50137,  13829,  63966
218750,22016, 0.0000000, 0.0334311, 0.0088168,     0,  2131, 177956,  63743, 241699
218751,22016, 0.0000000, 0.0222613, 0.0058709,     0,  1419, 177956,  63743, 241699
218752,22016, 0.0000000, 0.0020708, 0.0005461,     0,   132, 177956,  63743, 241699
218753,22016, 0.0000000, 0.0247086, 0.0065164,     0,  1575, 177956,  63743, 241699
218754,22016, 0.0469105, 0.0077656, 0.0365868,  8348,   495, 177956,  63743, 241699
218755,22016, 0.0035739, 0.0299013, 0.0105172,   636,  1906, 177956,  63743, 241699
218755,22017, 0.0000000, 0.0004528, 0.0001104,     0,     7,  47952,  15461,  63413
218756,22016, 0.0000000, 0.0000941, 0.0000248,     0,     6, 177956,  63743, 241699
218757,22016, 0.0201061, 0.0003451, 0.0148946,  3578,    22, 177956,  63743, 241699
218762,13059, 0.0000000, 0.0003080, 0.0002567,     0,     9,   5844,  29223,  35067
218763,13029, 0.0000000, 0.0299954, 0.0192303,     0,   851,  15882,  28371,  44253
218764,13029, 0.0000000, 0.0647845, 0.0415339,     0,  1838,  15882,  28371,  44253
218765,13029, 0.0000000, 0.0117021, 0.0075023,     0,   332,  15882,  28371,  44253
218766,13029, 0.0000000, 0.0203729, 0.0130613,     0,   578,  15882,  28371,  44253
218767,13029, 0.0000000, 0.0341546, 0.0218968,     0,   969,  15882,  28371,  44253
218768,13029, 0.0000000, 0.0369391, 0.0236820,     0,  1048,  15882,  28371,  44253
218769,13029, 0.0000000, 0.0009869, 0.0006327,     0,    28,  15882,  28371,  44253
218770,13029, 0.0000000, 0.0440238, 0.0282241,     0,  1249,  15882,  28371,  44253
218772,13006, 0.0000000, 0.0122611, 0.0112824,     0,   213,   1507,  17372,  18879
218773,13006, 0.0000000, 0.0054110, 0.0049791,     0,    94,   1507,  17372,  18879
218774,13006, 0.0000000, 0.0058140, 0.0053499,     0,   101,   1507,  17372,  18879
218775,13006, 0.0000000, 0.0341354, 0.0314106,     0,   593,   1507,  17372,  18879
218776,13006, 0.0000000, 0.1194451, 0.1099105,     0,  2075,   1507,  17372,  18879
218777,13006, 0.0000000, 0.0382800, 0.0352243,     0,   665,   1507,  17372,  18879
218779,13030, 0.0000000, 0.0027049, 0.0014358,     0,   124,  40521,  45842,  86363
218780,13030, 0.0000000, 0.0181929, 0.0096569,     0,   834,  40521,  45842,  86363
218782,13030, 0.0125367, 0.0544915, 0.0348066,   508,  2498,  40521,  45842,  86363
218783,13030, 0.0056761, 0.0456568, 0.0268981,   230,  2093,  40521,  45842,  86363
218785,13055, 0.0000000, 0.0118841, 0.0102410,     0,   164,   2214,  13800,  16014
218785,13030, 0.0000000, 0.0110379, 0.0058590,     0,   506,  40521,  45842,  86363
218790,13055, 0.0000000, 0.0738406, 0.0636318,     0,  1019,   2214,  13800,  16014
218792,13003, 0.0000000, 0.0039683, 0.0011971,     0,    65,  37919,  16380,  54299
218793,13037, 0.0000000, 0.0092983, 0.0079545,     0,   172,   3125,  18498,  21623
218796,13012, 0.0000000, 0.0035063, 0.0025612,     0,    69,   7261,  19679,  26940
218797,13012, 0.0000000, 0.0007622, 0.0005568,     0,    15,   7261,  19679,  26940
218798,13012, 0.0000000, 0.0517811, 0.0378248,     0,  1019,   7261,  19679,  26940
218799,13012, 0.0000000, 0.0205803, 0.0150334,     0,   405,   7261,  19679,  26940
218800,13012, 0.0000000, 0.0027440, 0.0020045,     0,    54,   7261,  19679,  26940
218801,13036, 0.0000000, 0.0106618, 0.0087569,     0,    82,   1673,   7691,   9364
218802,13036, 0.0000000, 0.0114419, 0.0093977,     0,    88,   1673,   7691,   9364
218803,13012, 0.0000000, 0.0167183, 0.0122123,     0,   329,   7261,  19679,  26940
218805,30072, 0.0000000, 0.0523981, 0.0392487,     0,   815,   5211,  15554,  20765
218806,30072, 0.0000000, 0.0611418, 0.0457982,     0,   951,   5211,  15554,  20765
218807,30072, 0.0000000, 0.0223737, 0.0167590,     0,   348,   5211,  15554,  20765
218808,30198, 0.0000000, 0.0388555, 0.0352300,     0,   239,    633,   6151,   6784
218810,30198, 0.0000000, 0.0619411, 0.0561616,     0,   381,    633,   6151,   6784
218811,30198, 0.0000000, 0.0188587, 0.0170991,     0,   116,    633,   6151,   6784
218812,13004, 0.0000000, 0.0605410, 0.0470314,     0,   423,   2007,   6987,   8994
218813,13053, 0.0000000, 0.0014773, 0.0012681,     0,    23,   2568,  15569,  18137
218814,13053, 0.0000000, 0.0159291, 0.0136737,     0,   248,   2568,  15569,  18137
218815,13053, 0.0000000, 0.0654506, 0.0561835,     0,  1019,   2568,  15569,  18137
218816,13060, 0.0000000, 0.0069045, 0.0059282,     0,   102,   2433,  14773,  17206
218816,13053, 0.9941589, 0.1626951, 0.2804212,  2553,  2533,   2568,  15569,  18137
218817,13060, 0.0000000, 0.0014215, 0.0012205,     0,    21,   2433,  14773,  17206
218817,13027, 0.0000000, 0.0010294, 0.0008063,     0,    19,   5105,  18458,  23563
218817,13053, 0.0000000, 0.0001285, 0.0001103,     0,     2,   2568,  15569,  18137
218818,13060, 0.0000000, 0.0060245, 0.0051726,     0,    89,   2433,  14773,  17206
218818,13027, 0.0000000, 0.0576986, 0.0451980,     0,  1065,   5105,  18458,  23563
218820,13027, 0.0000000, 0.0568317, 0.0445189,     0,  1049,   5105,  18458,  23563
218820,21187, 0.0000000, 0.0591359, 0.0452447,     0,   245,   1272,   4143,   5415
218821,21187, 0.0000000, 0.2063722, 0.1578947,     0,   855,   1272,   4143,   5415
218822,21187, 0.0000000, 0.0707217, 0.0541090,     0,   293,   1272,   4143,   5415
218823,21187, 0.0000000, 0.0195510, 0.0149584,     0,    81,   1272,   4143,   5415
218823,21178, 0.0000000, 0.0246273, 0.0222027,     0,   380,   1685,  15430,  17115
218824,21178, 0.0000000, 0.0157485, 0.0141981,     0,   243,   1685,  15430,  17115
218825,21178, 0.0000000, 0.0089436, 0.0080631,     0,   138,   1685,  15430,  17115
218826,21178, 0.0000000, 0.0992223, 0.0894537,     0,  1531,   1685,  15430,  17115
218827,21197, 0.1188482, 0.0127323, 0.0809249,  5774,   344,  48583,  27018,  75601
218827,21086, 0.0000000, 0.0499548, 0.0484578,     0,   608,    376,  12171,  12547
218828,21086, 0.0000000, 0.1816613, 0.1762174,     0,  2211,    376,  12171,  12547
218829,21197, 0.0000000, 0.0030720, 0.0010979,     0,    83,  48583,  27018,  75601
218832,30051, 0.0000000, 0.0002237, 0.0001375,     0,     3,   8413,  13409,  21822
218833,30051, 0.0000000, 0.0031322, 0.0019247,     0,    42,   8413,  13409,  21822
218834,30051, 0.0000000, 0.0009695, 0.0005957,     0,    13,   8413,  13409,  21822
218835,30051, 0.0000000, 0.1090312, 0.0669966,     0,  1462,   8413,  13409,  21822
219807,22012, 0.1259948, 0.0023863, 0.0992715,  6317,    33,  50137,  13829,  63966
219808,22012, 0.0799210, 0.0130884, 0.0654723,  4007,   181,  50137,  13829,  63966
219809,22012, 0.0556276, 0.0023140, 0.0441016,  2789,    32,  50137,  13829,  63966
219810,22012, 0.0000000, 0.0071589, 0.0015477,     0,    99,  50137,  13829,  63966
219811,22016, 0.0000000, 0.0653876, 0.0172446,     0,  4168, 177956,  63743, 241699
219813,22016, 0.0233148, 0.0098991, 0.0197767,  4149,   631, 177956,  63743, 241699
219814,22017, 0.0213130, 0.0003234, 0.0161954,  1022,     5,  47952,  15461,  63413
219815,22017, 0.0812896, 0.0081495, 0.0634570,  3898,   126,  47952,  15461,  63413
219816,22017, 0.0000000, 0.0369316, 0.0090045,     0,   571,  47952,  15461,  63413
219822,13059, 0.0000000, 0.0580707, 0.0483931,     0,  1697,   5844,  29223,  35067
219825,13059, 0.0000000, 0.0114978, 0.0095817,     0,   336,   5844,  29223,  35067
219825,13029, 0.0000000, 0.0014451, 0.0009265,     0,    41,  15882,  28371,  44253
219827,13029, 0.0000000, 0.0023616, 0.0015140,     0,    67,  15882,  28371,  44253
219828,13029, 0.0000000, 0.0005992, 0.0003842,     0,    17,  15882,  28371,  44253
219829,13006, 0.0000000, 0.0012088, 0.0011123,     0,    21,   1507,  17372,  18879
219829,13059, 0.0000000, 0.0101974, 0.0084980,     0,   298,   5844,  29223,  35067
219831,13006, 0.0000000, 0.0231407, 0.0212935,     0,   402,   1507,  17372,  18879
219832,13006, 0.0000000, 0.0191688, 0.0176386,     0,   333,   1507,  17372,  18879
219833,13006, 0.0000000, 0.0338476, 0.0311457,     0,   588,   1507,  17372,  18879
219835,13006, 0.0000000, 0.0883606, 0.0813073,     0,  1535,   1507,  17372,  18879
219840,13030, 0.0361788, 0.0694778, 0.0538541,  1466,  3185,  40521,  45842,  86363
219841,13030, 0.0407443, 0.0333319, 0.0368097,  1651,  1528,  40521,  45842,  86363
219842,13030, 0.0074529, 0.0272676, 0.0179707,   302,  1250,  40521,  45842,  86363
219848,13055, 0.0000000, 0.0128986, 0.0111153,     0,   178,   2214,  13800,  16014
219849,13055, 0.0000000, 0.0036957, 0.0031847,     0,    51,   2214,  13800,  16014
219850,13055, 0.0000000, 0.0213043, 0.0183589,     0,   294,   2214,  13800,  16014
219851,13037, 0.0000000, 0.0070278, 0.0060121,     0,   130,   3125,  18498,  21623
219855,13037, 0.0000000, 0.0007568, 0.0006475,     0,    14,   3125,  18498,  21623
219856,13037, 0.0000000, 0.0050816, 0.0043472,     0,    94,   3125,  18498,  21623
219859,13037, 0.0000000, 0.0001622, 0.0001387,     0,     3,   3125,  18498,  21623
219860,13036, 0.0000000, 0.0544793, 0.0447458,     0,   419,   1673,   7691,   9364
219861,13036, 0.0000000, 0.0215837, 0.0177275,     0,   166,   1673,   7691,   9364
219862,13036, 0.0000000, 0.0253543, 0.0208244,     0,   195,   1673,   7691,   9364
219863,30072, 0.0000000, 0.0097081, 0.0072719,     0,   151,   5211,  15554,  20765
219864,30072, 0.0000000, 0.0185804, 0.0139177,     0,   289,   5211,  15554,  20765
219865,30072, 0.0000000, 0.0094509, 0.0070792,     0,   147,   5211,  15554,  20765
219866,30072, 0.0000000, 0.0329819, 0.0247050,     0,   513,   5211,  15554,  20765
219867,30198, 0.0000000, 0.0611283, 0.0554245,     0,   376,    633,   6151,   6784
219867,30072, 0.0000000, 0.0156873, 0.0117505,     0,   244,   5211,  15554,  20765
219868,30198, 0.0000000, 0.0318647, 0.0288915,     0,   196,    633,   6151,   6784
219869,30198, 0.0000000, 0.0721834, 0.0654481,     0,   444,    633,   6151,   6784
219870,30198, 1.0000000, 0.0310519, 0.1214623,   633,   191,    633,   6151,   6784
219871,30198, 0.0000000, 0.0760852, 0.0689858,     0,   468,    633,   6151,   6784
219871,13053, 0.0000000, 0.0045603, 0.0039146,     0,    71,   2568,  15569,  18137
219872,13053, 0.0000000, 0.0215171, 0.0184705,     0,   335,   2568,  15569,  18137
219873,13053, 0.0000000, 0.0275548, 0.0236533,     0,   429,   2568,  15569,  18137
219874,13053, 0.0000000, 0.0380243, 0.0326405,     0,   592,   2568,  15569,  18137
219875,13053, 0.0000000, 0.0484296, 0.0415725,     0,   754,   2568,  15569,  18137
219876,13053, 0.0000000, 0.0329501, 0.0282847,     0,   513,   2568,  15569,  18137
219877,13027, 0.0000000, 0.0002167, 0.0001698,     0,     4,   5105,  18458,  23563
219877,13053, 0.0000000, 0.0092491, 0.0079396,     0,   144,   2568,  15569,  18137
219878,13027, 0.0000000, 0.1012027, 0.0792768,     0,  1868,   5105,  18458,  23563
219878,13053, 0.0000000, 0.0001927, 0.0001654,     0,     3,   2568,  15569,  18137
219879,13027, 0.0000000, 0.0490302, 0.0384077,     0,   905,   5105,  18458,  23563
219879,21187, 0.0000000, 0.0024137, 0.0018467,     0,    10,   1272,   4143,   5415
219880,21187, 0.0000000, 0.1962346, 0.1501385,     0,   813,   1272,   4143,   5415
219880,13027, 0.0000000, 0.0003251, 0.0002546,     0,     6,   5105,  18458,  23563
219881,21178, 0.0000000, 0.0248218, 0.0223780,     0,   383,   1685,  15430,  17115
219881,21187, 1.0000000, 0.0019310, 0.2363804,  1272,     8,   1272,   4143,   5415
219882,21178, 0.0000000, 0.0773169, 0.0697049,     0,  1193,   1685,  15430,  17115
219882,21086, 0.0000000, 0.0104346, 0.0101219,     0,   127,    376,  12171,  12547
219883,21178, 0.0000000, 0.1130914, 0.1019574,     0,  1745,   1685,  15430,  17115
219883,21086, 0.0000000, 0.0359872, 0.0349087,     0,   438,    376,  12171,  12547
219884,21178, 0.0000000, 0.0365522, 0.0329535,     0,   564,   1685,  15430,  17115
219884,21086, 0.0000000, 0.0091200, 0.0088467,     0,   111,    376,  12171,  12547
219885,21178, 0.0000000, 0.0498380, 0.0449313,     0,   769,   1685,  15430,  17115
219885,21086, 0.0000000, 0.0002465, 0.0002391,     0,     3,    376,  12171,  12547
219886,21086, 0.0000000, 0.0387807, 0.0376186,     0,   472,    376,  12171,  12547
219886,21178, 0.0000000, 0.0001296, 0.0001169,     0,     2,   1685,  15430,  17115
219887,21086, 0.0000000, 0.0197190, 0.0191281,     0,   240,    376,  12171,  12547
219888,21086, 0.0000000, 0.0139676, 0.0135491,     0,   170,    376,  12171,  12547
219889,21197, 0.0000000, 0.0219483, 0.0078438,     0,   593,  48583,  27018,  75601
219889,21086, 0.0000000, 0.0063265, 0.0061369,     0,    77,    376,  12171,  12547
219890,30051, 0.0000000, 0.0410918, 0.0252497,     0,   551,   8413,  13409,  21822
219890,21197, 0.0000000, 0.0002961, 0.0001058,     0,     8,  48583,  27018,  75601
219892,30051, 0.0000000, 0.0005966, 0.0003666,     0,     8,   8413,  13409,  21822
219893,30051, 0.0000000, 0.0058170, 0.0035744,     0,    78,   8413,  13409,  21822
219893,21194, 0.0000000, 0.0947854, 0.0235927,     0,   658,  20948,   6942,  27890
219894,21194, 0.0000000, 0.0005762, 0.0001434,     0,     4,  20948,   6942,  27890
220866,22012, 0.0789038, 0.0568371, 0.0741331,  3956,   786,  50137,  13829,  63966
220867,22012, 0.1128508, 0.0333357, 0.0956602,  5658,   461,  50137,  13829,  63966
220870,22016, 0.0099126, 0.0004236, 0.0074100,  1764,    27, 177956,  63743, 241699
220871,22016, 0.0215278, 0.0020551, 0.0163923,  3831,   131, 177956,  63743, 241699
220872,22016, 0.0000000, 0.0014904, 0.0003931,     0,    95, 177956,  63743, 241699
220873,22017, 0.0000000, 0.0008408, 0.0002050,     0,    13,  47952,  15461,  63413
220874,22017, 0.0701952, 0.0431408, 0.0635989,  3366,   667,  47952,  15461,  63413
220875,22017, 0.0060060, 0.0722463, 0.0221563,   288,  1117,  47952,  15461,  63413
220876,22017, 0.0026902, 0.0063385, 0.0035797,   129,    98,  47952,  15461,  63413
220880,13059, 0.0000000, 0.0112925, 0.0094106,     0,   330,   5844,  29223,  35067
220881,13059, 0.0000000, 0.0275810, 0.0229846,     0,   806,   5844,  29223,  35067
220883,13059, 0.0000000, 0.0538275, 0.0448570,     0,  1573,   5844,  29223,  35067
220884,13059, 0.0000000, 0.0148171, 0.0123478,     0,   433,   5844,  29223,  35067
220885,13059, 0.0000000, 0.0230298, 0.0191918,     0,   673,   5844,  29223,  35067
220886,13029, 0.0000000, 0.0102570, 0.0065758,     0,   291,  15882,  28371,  44253
220887,13059, 0.0000000, 0.0003080, 0.0002567,     0,     9,   5844,  29223,  35067
220890,13006, 0.0000000, 0.0316026, 0.0290799,     0,   549,   1507,  17372,  18879
220890,13059, 0.0000000, 0.0025665, 0.0021388,     0,    75,   5844,  29223,  35067
220891,13006, 0.0000000, 0.0037417, 0.0034430,     0,    65,   1507,  17372,  18879
220892,13006, 0.0000000, 0.0053534, 0.0049261,     0,    93,   1507,  17372,  18879
220893,13006, 0.0000000, 0.0683859, 0.0629271,     0,  1188,   1507,  17372,  18879
220895,13058, 0.0000000, 0.0189010, 0.0147050,     0,   248,   3744,  13121,  16865
220895,13006, 0.0000000, 0.0342505, 0.0315165,     0,   595,   1507,  17372,  18879
220896,13030, 0.0000000, 0.0128703, 0.0068316,     0,   590,  40521,  45842,  86363
220896,13058, 0.0000000, 0.1397759, 0.1087459,     0,  1834,   3744,  13121,  16865
220897,13030, 0.0266282, 0.0201562, 0.0231928,  1079,   924,  40521,  45842,  86363
220898,13030, 0.2679845, 0.0024868, 0.1270567, 10859,   114,  40521,  45842,  86363
220899,13030, 0.4218800, 0.0412722, 0.2198511, 17095,  1892,  40521,  45842,  86363
220900,13030, 0.0000000, 0.0069369, 0.0036821,     0,   318,  40521,  45842,  86363
220901,13030, 0.0000000, 0.0344226, 0.0182717,     0,  1578,  40521,  45842,  86363
220906,13015, 0.0000000, 0.0035457, 0.0034189,     0,    63,    659,  17768,  18427
220907,13055, 0.0000000, 0.0021014, 0.0018109,     0,    29,   2214,  13800,  16014
220908,13055, 0.0000000, 0.0002174, 0.0001873,     0,     3,   2214,  13800,  16014
220911,13037, 0.0000000, 0.0668180, 0.0571614,     0,  1236,   3125,  18498,  21623
220914,13037, 0.0000000, 0.0041086, 0.0035148,     0,    76,   3125,  18498,  21623
220915,13037, 0.0000000, 0.0005406, 0.0004625,     0,    10,   3125,  18498,  21623
220916,13037, 0.0000000, 0.0286517, 0.0245109,     0,   530,   3125,  18498,  21623
220917,13037, 0.0000000, 0.0190291, 0.0162790,     0,   352,   3125,  18498,  21623
220918,13037, 0.0000000, 0.0003244, 0.0002775,     0,     6,   3125,  18498,  21623
220918,13036, 0.0000000, 0.0249642, 0.0205041,     0,   192,   1673,   7691,   9364
220919,13036, 0.0000000, 0.0019503, 0.0016019,     0,    15,   1673,   7691,   9364
220920,13036, 0.0000000, 0.0011702, 0.0009611,     0,     9,   1673,   7691,   9364
220921,30072, 0.0000000, 0.0110582, 0.0082832,     0,   172,   5211,  15554,  20765
220921,13036, 0.0000000, 0.0084514, 0.0069415,     0,    65,   1673,   7691,   9364
220922,30072, 0.0000000, 0.0159445, 0.0119432,     0,   248,   5211,  15554,  20765
220923,30072, 0.0000000, 0.0796580, 0.0596677,     0,  1239,   5211,  15554,  20765
220924,30072, 0.0000000, 0.0305388, 0.0228750,     0,   475,   5211,  15554,  20765
220925,30072, 0.0000000, 0.0093867, 0.0070311,     0,   146,   5211,  15554,  20765
220926,30072, 0.0000000, 0.0016716, 0.0012521,     0,    26,   5211,  15554,  20765
220927,30198, 0.0000000, 0.0282881, 0.0256486,     0,   174,    633,   6151,   6784
220928,30198, 0.0000000, 0.0477971, 0.0433373,     0,   294,    633,   6151,   6784
220929,30198, 0.0000000, 0.0534872, 0.0484965,     0,   329,    633,   6151,   6784
220930,30198, 0.0000000, 0.0276378, 0.0250590,     0,   170,    633,   6151,   6784
220931,13053, 0.0000000, 0.0148372, 0.0127364,     0,   231,   2568,  15569,  18137
220932,13053, 0.0000000, 0.0328216, 0.0281745,     0,   511,   2568,  15569,  18137
220933,13053, 0.0000000, 0.0118184, 0.0101450,     0,   184,   2568,  15569,  18137
220934,13053, 0.0000000, 0.0343632, 0.0294977,     0,   535,   2568,  15569,  18137
220935,13053, 0.0000000, 0.0165072, 0.0141699,     0,   257,   2568,  15569,  18137
220936,13053, 0.0000000, 0.0353908, 0.0303799,     0,   551,   2568,  15569,  18137
220937,13027, 0.0000000, 0.0075848, 0.0059415,     0,   140,   5105,  18458,  23563
220938,13027, 0.5525955, 0.1437317, 0.2323134,  2821,  2653,   5105,  18458,  23563
220939,13027, 0.2489716, 0.0015711, 0.0551712,  1271,    29,   5105,  18458,  23563
220940,13027, 0.1984329, 0.0003251, 0.0432458,  1013,     6,   5105,  18458,  23563
220941,21086, 0.0000000, 0.0256347, 0.0248665,     0,   312,    376,  12171,  12547
220941,21178, 0.0000000, 0.0208036, 0.0187555,     0,   321,   1685,  15430,  17115
220942,21086, 0.0000000, 0.0046833, 0.0045429,     0,    57,    376,  12171,  12547
220943,21086, 0.0000000, 0.0006573, 0.0006376,     0,     8,    376,  12171,  12547
220944,21086, 0.0000000, 0.0644154, 0.0624851,     0,   784,    376,  12171,  12547
220945,21086, 0.0000000, 0.0994166, 0.0964374,     0,  1210,    376,  12171,  12547
220946,21086, 0.0000000, 0.0550489, 0.0533992,     0,   670,    376,  12171,  12547
220949,21086, 0.0000000, 0.1440309, 0.1397147,     0,  1753,    376,  12171,  12547
220950,21086, 0.0000000, 0.0391094, 0.0379374,     0,   476,    376,  12171,  12547
220950,30051, 0.0000000, 0.0001492, 0.0000917,     0,     2,   8413,  13409,  21822
220951,30051, 0.0000000, 0.0417630, 0.0256622,     0,   560,   8413,  13409,  21822
220951,21194, 0.1757208, 0.0005762, 0.1321262,  3681,     4,  20948,   6942,  27890
220952,21194, 0.0000000, 0.2591472, 0.0645034,     0,  1799,  20948,   6942,  27890
220953,21194, 0.0000000, 0.0478248, 0.0119039,     0,   332,  20948,   6942,  27890
220954,30040, 0.0000000, 0.0009780, 0.0009780,     0,    14,      0,  14315,  14315
220955,30040, 0.0000000, 0.0127838, 0.0127838,     0,   183,      0,  14315,  14315
221925,22012, 0.0099527, 0.0024586, 0.0083326,   499,    34,  50137,  13829,  63966
221926,22012, 0.0087760, 0.0532215, 0.0183848,   440,   736,  50137,  13829,  63966
221927,22012, 0.0779863, 0.1346446, 0.0902354,  3910,  1862,  50137,  13829,  63966
221928,22012, 0.0505814, 0.0049172, 0.0407091,  2536,    68,  50137,  13829,  63966
221930,22016, 0.0000169, 0.0008001, 0.0002234,     3,    51, 177956,  63743, 241699
221932,22017, 0.0000000, 0.1194619, 0.0291265,     0,  1847,  47952,  15461,  63413
221933,22017, 0.0000000, 0.0117716, 0.0028701,     0,   182,  47952,  15461,  63413
221934,22017, 0.3858233, 0.0064032, 0.2933153, 18501,    99,  47952,  15461,  63413
221935,22017, 0.1246663, 0.0209560, 0.0993803,  5978,   324,  47952,  15461,  63413
221937,13059, 0.0000000, 0.0011635, 0.0009696,     0,    34,   5844,  29223,  35067
221938,13059, 0.0000000, 0.0420559, 0.0350472,     0,  1229,   5844,  29223,  35067
221939,13059, 0.0000000, 0.0145433, 0.0121197,     0,   425,   5844,  29223,  35067
221941,13059, 0.0000000, 0.0937275, 0.0781076,     0,  2739,   5844,  29223,  35067
221942,13059, 0.0000000, 0.0716901, 0.0597428,     0,  2095,   5844,  29223,  35067
221943,13059, 0.1687201, 0.0524587, 0.0718339,   986,  1533,   5844,  29223,  35067
221944,13059, 0.0000000, 0.0040721, 0.0033935,     0,   119,   5844,  29223,  35067
221945,13059, 0.0000000, 0.0077679, 0.0064733,     0,   227,   5844,  29223,  35067
221946,13029, 0.0000000, 0.0181876, 0.0116602,     0,   516,  15882,  28371,  44253
221947,13059, 0.0000000, 0.0178284, 0.0148573,     0,   521,   5844,  29223,  35067
221950,13006, 0.0000000, 0.0034538, 0.0031781,     0,    60,   1507,  17372,  18879
221951,13006, 0.0000000, 0.0037417, 0.0034430,     0,    65,   1507,  17372,  18879
221951,13058, 0.0000000, 0.0323908, 0.0252001,     0,   425,   3744,  13121,  16865
221952,13006, 0.0000000, 0.0092102, 0.0084750,     0,   160,   1507,  17372,  18879
221953,13058, 0.0000000, 0.0624952, 0.0486214,     0,   820,   3744,  13121,  16865
221954,13058, 0.0000000, 0.0665346, 0.0517640,     0,   873,   3744,  13121,  16865
221955,13058, 0.0000000, 0.0360491, 0.0280463,     0,   473,   3744,  13121,  16865
221956,13030, 0.0000000, 0.0128703, 0.0068316,     0,   590,  40521,  45842,  86363
221957,13030, 0.0185336, 0.0331137, 0.0262728,   751,  1518,  40521,  45842,  86363
221958,13030, 0.0796130, 0.0583744, 0.0683395,  3226,  2676,  40521,  45842,  86363
221959,13030, 0.0000000, 0.0406614, 0.0215833,     0,  1864,  40521,  45842,  86363
221960,13030, 0.0000000, 0.0485799, 0.0257865,     0,  2227,  40521,  45842,  86363
221961,13030, 0.0000000, 0.0166659, 0.0088464,     0,   764,  40521,  45842,  86363
221963,13015, 0.0000000, 0.0597141, 0.0575786,     0,  1061,    659,  17768,  18427
221964,13015, 0.0000000, 0.0046150, 0.0044500,     0,    82,    659,  17768,  18427
221965,13015, 0.0000000, 0.0053467, 0.0051555,     0,    95,    659,  17768,  18427
221966,13015, 0.0000000, 0.0069226, 0.0066750,     0,   123,    659,  17768,  18427
221966,13055, 0.0000000, 0.0003623, 0.0003122,     0,     5,   2214,  13800,  16014
221967,13037, 0.0000000, 0.0032436, 0.0027748,     0,    60,   3125,  18498,  21623
221968,13055, 0.0000000, 0.0099275, 0.0085550,     0,   137,   2214,  13800,  16014
221968,13037, 0.0000000, 0.0290842, 0.0248809,     0,   538,   3125,  18498,  21623
221971,13037, 0.0000000, 0.0069737, 0.0059659,     0,   129,   3125,  18498,  21623
221974,13037, 0.0000000, 0.0023786, 0.0020349,     0,    44,   3125,  18498,  21623
221975,13037, 0.0000000, 0.0269218, 0.0230310,     0,   498,   3125,  18498,  21623
221976,13037, 0.0000000, 0.0221646, 0.0189613,     0,   410,   3125,  18498,  21623
221979,13036, 0.0000000, 0.0816539, 0.0670654,     0,   628,   1673,   7691,   9364
221981,30072, 0.0000000, 0.0111225, 0.0083313,     0,   173,   5211,  15554,  20765
221982,30072, 0.0000000, 0.0331747, 0.0248495,     0,   516,   5211,  15554,  20765
221983,30072, 0.0000000, 0.0024431, 0.0018300,     0,    38,   5211,  15554,  20765
221984,30072, 0.0000000, 0.0103510, 0.0077534,     0,   161,   5211,  15554,  20765
221985,30072, 0.0000000, 0.0165874, 0.0124248,     0,   258,   5211,  15554,  20765
221986,30072, 0.0000000, 0.0055934, 0.0041897,     0,    87,   5211,  15554,  20765
221986,30198, 0.0000000, 0.0482848, 0.0437795,     0,   297,    633,   6151,   6784
221987,30198, 0.0000000, 0.0307267, 0.0278597,     0,   189,    633,   6151,   6784
221988,30198, 0.0000000, 0.0390180, 0.0353774,     0,   240,    633,   6151,   6784
221989,30198, 0.0000000, 0.0977077, 0.0885908,     0,   601,    633,   6151,   6784
221990,30198, 0.0000000, 0.0638921, 0.0579304,     0,   393,    633,   6151,   6784
221990,30180, 0.0000000, 0.0024267, 0.0021284,     0,    24,   1386,   9890,  11276
221991,13053, 0.0000000, 0.0226733, 0.0194630,     0,   353,   2568,  15569,  18137
221992,13053, 0.0000000, 0.0114330, 0.0098142,     0,   178,   2568,  15569,  18137
221993,13053, 0.0000000, 0.0179202, 0.0153829,     0,   279,   2568,  15569,  18137
221994,13053, 0.0000000, 0.0278117, 0.0238738,     0,   433,   2568,  15569,  18137
221995,13053, 0.0000000, 0.0320509, 0.0275128,     0,   499,   2568,  15569,  18137
221996,13027, 0.0000000, 0.0060137, 0.0047108,     0,   111,   5105,  18458,  23563
221996,13053, 0.0000000, 0.0030188, 0.0025914,     0,    47,   2568,  15569,  18137
221997,13027, 0.0000000, 0.0121357, 0.0095064,     0,   224,   5105,  18458,  23563
221998,13027, 0.0000000, 0.0215083, 0.0168484,     0,   397,   5105,  18458,  23563
221999,13027, 0.0000000, 0.0414996, 0.0325086,     0,   766,   5105,  18458,  23563
222000,21086, 0.0000000, 0.0206228, 0.0200048,     0,   251,    376,  12171,  12547
222002,21086, 1.0000000, 0.0007395, 0.0306846,   376,     9,    376,  12171,  12547
222003,21086, 0.0000000, 0.0823268, 0.0798597,     0,  1002,    376,  12171,  12547
222004,21086, 0.0000000, 0.0884890, 0.0858373,     0,  1077,    376,  12171,  12547
222004,21111, 0.0000000, 0.0046540, 0.0033632,     0,    62,   5113,  13322,  18435
222006,21086, 0.0000000, 0.0005751, 0.0005579,     0,     7,    376,  12171,  12547
222007,21086, 0.0000000, 0.0080519, 0.0078106,     0,    98,    376,  12171,  12547
222007,21194, 0.0000000, 0.0007203, 0.0001793,     0,     5,  20948,   6942,  27890
222008,21194, 0.0000000, 0.0057620, 0.0014342,     0,    40,  20948,   6942,  27890
222009,21194, 0.0025778, 0.0097954, 0.0043743,    54,    68,  20948,   6942,  27890
222010,21194, 0.4067692, 0.0335638, 0.3138759,  8521,   233,  20948,   6942,  27890
222011,21194, 0.0000000, 0.0102276, 0.0025457,     0,    71,  20948,   6942,  27890
222012,21194, 0.0000000, 0.1038606, 0.0258516,     0,   721,  20948,   6942,  27890
222013,21194, 0.0000000, 0.0030251, 0.0007530,     0,    21,  20948,   6942,  27890
222014,30040, 0.0000000, 0.0152288, 0.0152288,     0,   218,      0,  14315,  14315
222984,22012, 0.0530546, 0.0052065, 0.0427102,  2660,    72,  50137,  13829,  63966
222985,22012, 0.0000000, 0.1850459, 0.0400056,     0,  2559,  50137,  13829,  63966
222987,22012, 0.0000000, 0.0005785, 0.0001251,     0,     8,  50137,  13829,  63966
222987,22017, 0.0000000, 0.1424229, 0.0347247,     0,  2202,  47952,  15461,  63413
222988,22016, 0.0000000, 0.0001255, 0.0000331,     0,     8, 177956,  63743, 241699
222988,22017, 0.0890891, 0.0012936, 0.0676833,  4272,    20,  47952,  15461,  63413
222989,22017, 0.0000000, 0.0090550, 0.0022077,     0,   140,  47952,  15461,  63413
222990,22017, 0.0518435, 0.0021344, 0.0397237,  2486,    33,  47952,  15461,  63413
222991,22017, 0.0000000, 0.0012289, 0.0002996,     0,    19,  47952,  15461,  63413
222992,22017, 0.0000000, 0.0018757, 0.0004573,     0,    29,  47952,  15461,  63413
222993,22017, 0.0814356, 0.0092491, 0.0638355,  3905,   143,  47952,  15461,  63413
222994,22017, 0.0048382, 0.0018110, 0.0041001,   232,    28,  47952,  15461,  63413
222996,22007, 0.0000000, 0.0000690, 0.0000262,     0,     1,  23622,  14501,  38123
222999,13059, 0.0000000, 0.0612531, 0.0510451,     0,  1790,   5844,  29223,  35067
223000,13059, 0.0000000, 0.1258940, 0.1049135,     0,  3679,   5844,  29223,  35067
223001,13059, 0.0054757, 0.0058858, 0.0058174,    32,   172,   5844,  29223,  35067
223002,13059, 0.8258042, 0.0213188, 0.1553883,  4826,   623,   5844,  29223,  35067
223003,13059, 0.0000000, 0.0078705, 0.0065589,     0,   230,   5844,  29223,  35067
223004,13059, 0.0000000, 0.0000684, 0.0000570,     0,     2,   5844,  29223,  35067
223005,13059, 0.0000000, 0.0235431, 0.0196196,     0,   688,   5844,  29223,  35067
223006,13059, 0.0000000, 0.0104712, 0.0087262,     0,   306,   5844,  29223,  35067
223007,13059, 0.0000000, 0.0165623, 0.0138022,     0,   484,   5844,  29223,  35067
223009,13058, 0.0000000, 0.0065544, 0.0050993,     0,    86,   3744,  13121,  16865
223010,13058, 0.0000000, 0.0374209, 0.0291135,     0,   491,   3744,  13121,  16865
223011,13058, 0.0000000, 0.1257526, 0.0978358,     0,  1650,   3744,  13121,  16865
223013,13058, 0.4879808, 0.1070803, 0.1916395,  1827,  1405,   3744,  13121,  16865
223014,13058, 0.1164530, 0.1224754, 0.1211385,   436,  1607,   3744,  13121,  16865
223016,13030, 0.0000000, 0.0372584, 0.0197770,     0,  1708,  40521,  45842,  86363
223017,13030, 0.0000000, 0.0368876, 0.0195801,     0,  1691,  40521,  45842,  86363
223018,13030, 0.0000000, 0.0334628, 0.0177622,     0,  1534,  40521,  45842,  86363
223019,13030, 0.0000000, 0.0064788, 0.0034390,     0,   297,  40521,  45842,  86363
223020,13030, 0.0000000, 0.0064133, 0.0034042,     0,   294,  40521,  45842,  86363
223022,13015, 0.0000000, 0.0858847, 0.0828133,     0,  1526,    659,  17768,  18427
223023,13015, 0.0000000, 0.0055718, 0.0053726,     0,    99,    659,  17768,  18427
223024,13015, 0.0000000, 0.0070351, 0.0067835,     0,   125,    659,  17768,  18427
223026,13055, 0.0000000, 0.0018841, 0.0016236,     0,    26,   2214,  13800,  16014
223028,13037, 0.0000000, 0.0039464, 0.0033760,     0,    73,   3125,  18498,  21623
223029,13037, 0.0000000, 0.0078387, 0.0067058,     0,   145,   3125,  18498,  21623
223031,13037, 0.0000000, 0.0154071, 0.0131804,     0,   285,   3125,  18498,  21623
223032,13037, 0.0000000, 0.0283274, 0.0242335,     0,   524,   3125,  18498,  21623
223034,13037, 0.0000000, 0.0342740, 0.0293206,     0,   634,   3125,  18498,  21623
223034,13036, 0.0000000, 0.0066311, 0.0054464,     0,    51,   1673,   7691,   9364
223035,13036, 0.0000000, 0.0295150, 0.0242418,     0,   227,   1673,   7691,   9364
223036,13036, 0.1267185, 0.1207905, 0.1218496,   212,   929,   1673,   7691,   9364
223037,13036, 0.8732815, 0.1081784, 0.2448740,  1461,   832,   1673,   7691,   9364
223040,30072, 0.0000000, 0.0045647, 0.0034192,     0,    71,   5211,  15554,  20765
223040,13036, 0.0000000, 0.0180731, 0.0148441,     0,   139,   1673,   7691,   9364
223042,30072, 0.3277682, 0.0199949, 0.0972309,  1708,   311,   5211,  15554,  20765
223043,30072, 0.0000000, 0.0137585, 0.0103058,     0,   214,   5211,  15554,  20765
223044,30198, 0.0000000, 0.0048773, 0.0044222,     0,    30,    633,   6151,   6784
223045,30198, 0.0000000, 0.0084539, 0.0076651,     0,    52,    633,   6151,   6784
223046,30198, 0.0000000, 0.0099171, 0.0089917,     0,    61,    633,   6151,   6784
223047,30198, 0.0000000, 0.0341408, 0.0309552,     0,   210,    633,   6151,   6784
223049,30180, 0.0000000, 0.0108190, 0.0094892,     0,   107,   1386,   9890,  11276
223049,30198, 0.0000000, 0.0024386, 0.0022111,     0,    15,    633,   6151,   6784
223050,30180, 0.0000000, 0.0170880, 0.0149876,     0,   169,   1386,   9890,  11276
223051,13053, 0.0000000, 0.0143876, 0.0123504,     0,   224,   2568,  15569,  18137
223052,13053, 0.0000000, 0.0057165, 0.0049071,     0,    89,   2568,  15569,  18137
223052,30180, 0.0000000, 0.0013145, 0.0011529,     0,    13,   1386,   9890,  11276
223053,13053, 0.0000000, 0.0169568, 0.0145559,     0,   264,   2568,  15569,  18137
223054,13053, 0.0000000, 0.0241506, 0.0207311,     0,   376,   2568,  15569,  18137
223055,13053, 0.0000000, 0.0727086, 0.0624138,     0,  1132,   2568,  15569,  18137
223056,13053, 0.0000000, 0.0341705, 0.0293323,     0,   532,   2568,  15569,  18137
223057,13027, 0.0000000, 0.0094268, 0.0073845,     0,   174,   5105,  18458,  23563
223058,13027, 0.0000000, 0.0736808, 0.0577176,     0,  1360,   5105,  18458,  23563
223059,30083, 0.0000000, 0.0025746, 0.0023886,     0,   119,   3599,  46221,  49820
223060,21111, 0.0000000, 0.0741630, 0.0535937,     0,   988,   5113,  13322,  18435
223061,21111, 0.2968903, 0.0198919, 0.0967182,  1518,   265,   5113,  13322,  18435
223062,21111, 0.0000000, 0.0517190, 0.0373746,     0,   689,   5113,  13322,  18435
223063,21111, 0.0000000, 0.0242456, 0.0175210,     0,   323,   5113,  13322,  18435
223064,21111, 0.0000000, 0.0018766, 0.0013561,     0,    25,   5113,  13322,  18435
223065,21111, 0.0000000, 0.0014262, 0.0010306,     0,    19,   5113,  13322,  18435
223065,21194, 0.0000000, 0.0109479, 0.0027250,     0,    76,  20948,   6942,  27890
223066,21194, 0.0000000, 0.0076347, 0.0019003,     0,    53,  20948,   6942,  27890
223067,21194, 0.0000000, 0.0063382, 0.0015776,     0,    44,  20948,   6942,  27890
223069,21194, 0.0000000, 0.0339960, 0.0084618,     0,   236,  20948,   6942,  27890
223070,21194, 0.2974031, 0.0048977, 0.2245966,  6230,    34,  20948,   6942,  27890
223071,21194, 0.0015753, 0.0103717, 0.0037648,    33,    72,  20948,   6942,  27890
223072,21194, 0.0000000, 0.0034572, 0.0008605,     0,    24,  20948,   6942,  27890
223073,21194, 0.0000000, 0.0157015, 0.0039082,     0,   109,  20948,   6942,  27890
224043,22012, 0.0000000, 0.0000723, 0.0000156,     0,     1,  50137,  13829,  63966
224043,22005, 0.0000000, 0.0949986, 0.0694848,     0,  4042,  15623,  42548,  58171
224044,22005, 0.0000000, 0.0175096, 0.0128071,     0,   745,  15623,  42548,  58171
224045,22005, 0.0000000, 0.0198599, 0.0145261,     0,   845,  15623,  42548,  58171
224046,22005, 0.0000000, 0.0003055, 0.0002235,     0,    13,  15623,  42548,  58171
224047,22017, 0.0000000, 0.0000647, 0.0000158,     0,     1,  47952,  15461,  63413
224049,22017, 0.0085294, 0.0743807, 0.0245849,   409,  1150,  47952,  15461,  63413
224051,22017, 0.0000000, 0.1937779, 0.0472458,     0,  2996,  47952,  15461,  63413
224052,22017, 0.0159743, 0.0026518, 0.0127261,   766,    41,  47952,  15461,  63413
224053,22007, 0.0000000, 0.0001379, 0.0000525,     0,     2,  23622,  14501,  38123
224054,22007, 0.0000000, 0.0124129, 0.0047216,     0,   180,  23622,  14501,  38123
224055,22007, 0.0000000, 0.0159299, 0.0060593,     0,   231,  23622,  14501,  38123
224056,22007, 0.0000000, 0.0006206, 0.0002361,     0,     9,  23622,  14501,  38123
224057,22007, 0.0000000, 0.0211020, 0.0080267,     0,   306,  23622,  14501,  38123
224057,22004, 0.0000000, 0.0000417, 0.0000417,     0,     2,      0,  47952,  47952
224058,13059, 0.0000000, 0.0015741, 0.0013118,     0,    46,   5844,  29223,  35067
224058,22004, 0.0000000, 0.0007090, 0.0007090,     0,    34,      0,  47952,  47952
224059,13059, 0.0000000, 0.0161517, 0.0134599,     0,   472,   5844,  29223,  35067
224059,22004, 0.0000000, 0.0045879, 0.0045879,     0,   220,      0,  47952,  47952
224060,13059, 0.0000000, 0.0352804, 0.0294009,     0,  1031,   5844,  29223,  35067
224061,13059, 0.0000000, 0.0434247, 0.0361879,     0,  1269,   5844,  29223,  35067
224062,13059, 0.0000000, 0.0151251, 0.0126044,     0,   442,   5844,  29223,  35067
224065,13059, 0.0000000, 0.0068439, 0.0057034,     0,   200,   5844,  29223,  35067
224066,13059, 0.0000000, 0.0054409, 0.0045342,     0,   159,   5844,  29223,  35067
224068,13058, 0.0000000, 0.0158524, 0.0123332,     0,   208,   3744,  13121,  16865
224070,13058, 0.0000000, 0.0137185, 0.0106730,     0,   180,   3744,  13121,  16865
224071,13058, 0.0000000, 0.0378782, 0.0294693,     0,   497,   3744,  13121,  16865
224071,13084, 0.0000000, 0.0002374, 0.0002374,     0,     6,      0,  25273,  25273
224072,13058, 0.3330662, 0.1265910, 0.1724281,  1247,  1661,   3744,  13121,  16865
224073,13058, 0.0627671, 0.0108986, 0.0224133,   235,   143,   3744,  13121,  16865
224074,13030, 0.0000000, 0.0129575, 0.0068779,     0,   594,  40521,  45842,  86363
224075,13030, 0.0000000, 0.0140919, 0.0074801,     0,   646,  40521,  45842,  86363
224076,13030, 0.0000000, 0.0049082, 0.0026053,     0,   225,  40521,  45842,  86363
224077,13030, 0.0000000, 0.0340736, 0.0180864,     0,  1562,  40521,  45842,  86363
224078,13030, 0.0000000, 0.0093582, 0.0049674,     0,   429,  40521,  45842,  86363
224078,13015, 0.0000000, 0.0074291, 0.0071634,     0,   132,    659,  17768,  18427
224079,13015, 0.0000000, 0.0516096, 0.0497639,     0,   917,    659,  17768,  18427
224081,13015, 0.0000000, 0.0293224, 0.0282737,     0,   521,    659,  17768,  18427
224082,13015, 0.0000000, 0.0024201, 0.0023335,     0,    43,    659,  17768,  18427
224083,13015, 0.0000000, 0.0010693, 0.0010311,     0,    19,    659,  17768,  18427
224085,13037, 0.0000000, 0.0048113, 0.0041160,     0,    89,   3125,  18498,  21623
224087,13037, 0.0000000, 0.0028652, 0.0024511,     0,    53,   3125,  18498,  21623
224088,13037, 0.0000000, 0.0018921, 0.0016186,     0,    35,   3125,  18498,  21623
224089,13037, 0.0000000, 0.0055141, 0.0047172,     0,   102,   3125,  18498,  21623
224090,13037, 0.0000000, 0.0015677, 0.0013412,     0,    29,   3125,  18498,  21623
224091,13037, 0.0000000, 0.0075143, 0.0064283,     0,   139,   3125,  18498,  21623
224092,13037, 0.0000000, 0.0411936, 0.0352403,     0,   762,   3125,  18498,  21623
224093,13037, 0.0000000, 0.0103254, 0.0088332,     0,   191,   3125,  18498,  21623
224095,13036, 0.0000000, 0.0145625, 0.0119607,     0,   112,   1673,   7691,   9364
224096,13036, 0.0000000, 0.0107918, 0.0088637,     0,    83,   1673,   7691,   9364
224097,13036, 0.0000000, 0.0600702, 0.0493379,     0,   462,   1673,   7691,   9364
224098,13036, 0.0000000, 0.0287349, 0.0236010,     0,   221,   1673,   7691,   9364
224100,30072, 0.0000000, 0.0244310, 0.0183000,     0,   380,   5211,  15554,  20765
224101,30072, 0.6722318, 0.0510480, 0.2069348,  3503,   794,   5211,  15554,  20765
224102,30072, 0.0000000, 0.0051434, 0.0038526,     0,    80,   5211,  15554,  20765
224103,30072, 0.0000000, 0.0057863, 0.0043342,     0,    90,   5211,  15554,  20765
224104,30072, 0.0000000, 0.0127941, 0.0095834,     0,   199,   5211,  15554,  20765
224105,30198, 0.0000000, 0.0004877, 0.0004422,     0,     3,    633,   6151,   6784
224106,30198, 0.0000000, 0.0048773, 0.0044222,     0,    30,    633,   6151,   6784
224107,30198, 0.0000000, 0.0495854, 0.0449587,     0,   305,    633,   6151,   6784
224108,30198, 0.0000000, 0.0180458, 0.0163620,     0,   111,    633,   6151,   6784
224109,30180, 0.0000000, 0.0075834, 0.0066513,     0,    75,   1386,   9890,  11276
224110,30180, 0.0000000, 0.0398382, 0.0349415,     0,   394,   1386,   9890,  11276
224111,30180, 0.0000000, 0.0140546, 0.0123271,     0,   139,   1386,   9890,  11276
224112,30180, 0.0000000, 0.0162791, 0.0142781,     0,   161,   1386,   9890,  11276
224113,13053, 0.0000000, 0.0030188, 0.0025914,     0,    47,   2568,  15569,  18137
224114,13053, 0.0000000, 0.0040465, 0.0034736,     0,    63,   2568,  15569,  18137
224116,13027, 0.0000000, 0.1143678, 0.0895896,     0,  2111,   5105,  18458,  23563
224117,13027, 0.0000000, 0.0660960, 0.0517761,     0,  1220,   5105,  18458,  23563
224118,30083, 0.0000000, 0.0022717, 0.0021076,     0,   105,   3599,  46221,  49820
224119,21111, 0.0000000, 0.0831707, 0.0601031,     0,  1108,   5113,  13322,  18435
224120,21111, 0.0960297, 0.0353551, 0.0521833,   491,   471,   5113,  13322,  18435
224121,21111, 0.0000000, 0.0545714, 0.0394359,     0,   727,   5113,  13322,  18435
224122,21111, 0.0199491, 0.0818946, 0.0647139,   102,  1091,   5113,  13322,  18435
224123,21111, 0.5871308, 0.0185408, 0.1762408,  3002,   247,   5113,  13322,  18435
224124,21111, 0.0000000, 0.0298754, 0.0215894,     0,   398,   5113,  13322,  18435
224125,21111, 0.0000000, 0.0362558, 0.0262002,     0,   483,   5113,  13322,  18435
224126,21194, 0.0000000, 0.0030251, 0.0007530,     0,    21,  20948,   6942,  27890
224127,21194, 0.0000000, 0.0074906, 0.0018645,     0,    52,  20948,   6942,  27890
224128,21194, 0.0000000, 0.0508499, 0.0126569,     0,   353,  20948,   6942,  27890
224129,21194, 0.0000000, 0.0001441, 0.0000359,     0,     1,  20948,   6942,  27890
224130,21194, 0.0000000, 0.0015846, 0.0003944,     0,    11,  20948,   6942,  27890
224131,21194, 0.0000000, 0.0021608, 0.0005378,     0,    15,  20948,   6942,  27890
224132,21194, 0.0000000, 0.0010084, 0.0002510,     0,     7,  20948,   6942,  27890
225102,22005, 0.0000000, 0.0681348, 0.0498358,     0,  2899,  15623,  42548,  58171
225103,22005, 0.0000000, 0.0350428, 0.0256313,     0,  1491,  15623,  42548,  58171
225104,22005, 0.2000896, 0.0003995, 0.0540304,  3126,    17,  15623,  42548,  58171
225105,22005, 0.0000000, 0.0189433, 0.0138557,     0,   806,  15623,  42548,  58171
225107,22017, 0.0000000, 0.0003881, 0.0000946,     0,     6,  47952,  15461,  63413
225108,22017, 0.0000000, 0.0002587, 0.0000631,     0,     4,  47952,  15461,  63413
225109,22017, 0.0000000, 0.0007761, 0.0001892,     0,    12,  47952,  15461,  63413
225110,22017, 0.0000000, 0.0833711, 0.0203271,     0,  1289,  47952,  15461,  63413
225111,22017, 0.0000000, 0.0026518, 0.0006466,     0,    41,  47952,  15461,  63413
225111,22007, 0.0000000, 0.0002069, 0.0000787,     0,     3,  23622,  14501,  38123
225113,22007, 0.0000000, 0.0280670, 0.0106760,     0,   407,  23622,  14501,  38123
225114,22007, 0.0000000, 0.0001379, 0.0000525,     0,     2,  23622,  14501,  38123
225115,22007, 0.0000000, 0.0208261, 0.0079217,     0,   302,  23622,  14501,  38123
225116,22004, 0.0000000, 0.0108650, 0.0108650,     0,   521,      0,  47952,  47952
225117,22004, 0.0000000, 0.0063814, 0.0063814,     0,   306,      0,  47952,  47952
225118,22004, 0.0000000, 0.0248790, 0.0248790,     0,  1193,      0,  47952,  47952
225119,22004, 0.0000000, 0.0007925, 0.0007925,     0,    38,      0,  47952,  47952
225120,13059, 0.0000000, 0.0101974, 0.0084980,     0,   298,   5844,  29223,  35067
225120,22004, 0.0000000, 0.0049007, 0.0049007,     0,   235,      0,  47952,  47952
225122,13059, 0.0000000, 0.0302844, 0.0252374,     0,   885,   5844,  29223,  35067
225124,13059, 0.0000000, 0.0326113, 0.0271765,     0,   953,   5844,  29223,  35067
225126,13058, 0.0000000, 0.0153190, 0.0119182,     0,   201,   3744,  13121,  16865
225127,13058, 0.0000000, 0.0227117, 0.0176697,     0,   298,   3744,  13121,  16865
225129,13058, 0.0000000, 0.0016005, 0.0012452,     0,    21,   3744,  13121,  16865
225130,13084, 0.0000000, 0.0036007, 0.0036007,     0,    91,      0,  25273,  25273
225133,13030, 0.0000000, 0.0024214, 0.0012853,     0,   111,  40521,  45842,  86363
225134,13030, 0.0000000, 0.0036429, 0.0019337,     0,   167,  40521,  45842,  86363
225135,13030, 0.0000000, 0.0296889, 0.0157591,     0,  1361,  40521,  45842,  86363
225136,13030, 0.0000000, 0.0197199, 0.0104674,     0,   904,  40521,  45842,  86363
225137,13015, 0.0000000, 0.1035007, 0.0997992,     0,  1839,    659,  17768,  18427
225138,13015, 0.0000000, 0.0277465, 0.0267542,     0,   493,    659,  17768,  18427
225139,13015, 0.0000000, 0.0270149, 0.0260487,     0,   480,    659,  17768,  18427
225142,13015, 0.0000000, 0.0198672, 0.0191567,     0,   353,    659,  17768,  18427
225145,13037, 0.0000000, 0.0048654, 0.0041622,     0,    90,   3125,  18498,  21623
225148,13037, 0.0000000, 0.0236782, 0.0202562,     0,   438,   3125,  18498,  21623
225149,13037, 0.0000000, 0.0435182, 0.0372289,     0,   805,   3125,  18498,  21623
225150,13037, 0.5814400, 0.0178938, 0.0993387,  1817,   331,   3125,  18498,  21623
225151,13037, 0.0000000, 0.0133528, 0.0114230,     0,   247,   3125,  18498,  21623
225152,13037, 0.0000000, 0.0015677, 0.0013412,     0,    29,   3125,  18498,  21623
225153,13081, 0.0000000, 0.0055842, 0.0016031,     0,    52,  23125,   9312,  32437
225155,13036, 0.0000000, 0.0183331, 0.0150577,     0,   141,   1673,   7691,   9364
225156,13036, 0.0000000, 0.1181901, 0.0970739,     0,   909,   1673,   7691,   9364
225158,13036, 0.0000000, 0.1811208, 0.1487612,     0,  1393,   1673,   7691,   9364
225159,30072, 0.0000000, 0.0342677, 0.0256682,     0,   533,   5211,  15554,  20765
225160,30072, 0.0000000, 0.0055934, 0.0041897,     0,    87,   5211,  15554,  20765
225162,30072, 0.0000000, 0.0086794, 0.0065013,     0,   135,   5211,  15554,  20765
225163,30170, 0.0000000, 0.0532955, 0.0477087,     0,   507,   1114,   9513,  10627
225164,30170, 0.9703770, 0.0111426, 0.1116966,  1081,   106,   1114,   9513,  10627
225165,30170, 0.0000000, 0.0684327, 0.0612591,     0,   651,   1114,   9513,  10627
225166,30198, 0.0000000, 0.0014632, 0.0013267,     0,     9,    633,   6151,   6784
225167,30198, 0.0000000, 0.0001626, 0.0001474,     0,     1,    633,   6151,   6784
225168,30198, 0.0000000, 0.0336531, 0.0305130,     0,   207,    633,   6151,   6784
225169,30180, 0.0000000, 0.0229525, 0.0201313,     0,   227,   1386,   9890,  11276
225170,30180, 0.0000000, 0.0577351, 0.0506385,     0,   571,   1386,   9890,  11276
225171,30180, 0.0000000, 0.0263903, 0.0231465,     0,   261,   1386,   9890,  11276
225172,13053, 0.0000000, 0.0017984, 0.0015438,     0,    28,   2568,  15569,  18137
225173,13053, 0.0000000, 0.0177275, 0.0152175,     0,   276,   2568,  15569,  18137
225175,13027, 0.0000000, 0.0202622, 0.0158723,     0,   374,   5105,  18458,  23563
225176,13027, 0.0000000, 0.0556940, 0.0436277,     0,  1028,   5105,  18458,  23563
225177,30083, 0.0000000, 0.0725428, 0.0673023,     0,  3353,   3599,  46221,  49820
225179,21111, 0.0000000, 0.0593755, 0.0429075,     0,   791,   5113,  13322,  18435
225180,21111, 0.0000000, 0.0448131, 0.0323841,     0,   597,   5113,  13322,  18435
225181,21111, 0.0000000, 0.0464645, 0.0335774,     0,   619,   5113,  13322,  18435
225182,21111, 0.0000000, 0.0276235, 0.0199620,     0,   368,   5113,  13322,  18435
225183,21111, 0.0000000, 0.0995346, 0.0719284,     0,  1326,   5113,  13322,  18435
225185,21194, 0.0000000, 0.0001441, 0.0000359,     0,     1,  20948,   6942,  27890
225186,21194, 0.0000000, 0.0358686, 0.0089279,     0,   249,  20948,   6942,  27890
225187,21194, 0.0000000, 0.1096226, 0.0272858,     0,   761,  20948,   6942,  27890
225188,30175, 0.0000000, 0.0085400, 0.0085400,     0,   416,      0,  48712,  48712
225189,21194, 0.0000000, 0.0002881, 0.0000717,     0,     2,  20948,   6942,  27890
225190,21194, 0.0000000, 0.0043215, 0.0010757,     0,    30,  20948,   6942,  27890
225191,21194, 0.0000000, 0.0488332, 0.0121549,     0,   339,  20948,   6942,  27890
225191,30175, 0.0000000, 0.0140417, 0.0140417,     0,   684,      0,  48712,  48712
226161,22005, 0.0000000, 0.0562424, 0.0411373,     0,  2393,  15623,  42548,  58171
226162,22005, 0.0000000, 0.0009166, 0.0006704,     0,    39,  15623,  42548,  58171
226163,22005, 0.0000000, 0.0596738, 0.0436472,     0,  2539,  15623,  42548,  58171
226164,22017, 0.0000000, 0.0003234, 0.0000788,     0,     5,  47952,  15461,  63413
226167,22017, 0.0000000, 0.1397710, 0.0340782,     0,  2161,  47952,  15461,  63413
226168,22007, 0.0000000, 0.0477208, 0.0181518,     0,   692,  23622,  14501,  38123
226168,22017, 0.0000000, 0.0031693, 0.0007727,     0,    49,  47952,  15461,  63413
226169,22017, 0.0000000, 0.0023284, 0.0005677,     0,    36,  47952,  15461,  63413
226169,22007, 0.0000000, 0.0264809, 0.0100727,     0,   384,  23622,  14501,  38123
226170,22007, 0.0000000, 0.0059306, 0.0022559,     0,    86,  23622,  14501,  38123
226171,22007, 0.0140547, 0.0970278, 0.0456155,   332,  1407,  23622,  14501,  38123
226172,22007, 0.1395309, 0.0018619, 0.0871652,  3296,    27,  23622,  14501,  38123
226173,22007, 0.0000000, 0.0238604, 0.0090759,     0,   346,  23622,  14501,  38123
226174,22007, 0.0000000, 0.0177919, 0.0067676,     0,   258,  23622,  14501,  38123
226176,22004, 0.0000000, 0.0045254, 0.0045254,     0,   217,      0,  47952,  47952
226179,22004, 0.0000000, 0.0096555, 0.0096555,     0,   463,      0,  47952,  47952
226180,22004, 0.0000000, 0.0078203, 0.0078203,     0,   375,      0,  47952,  47952
226184,13059, 0.0000000, 0.0113951, 0.0094961,     0,   333,   5844,  29223,  35067
226187,13084, 0.0000000, 0.0047877, 0.0047877,     0,   121,      0,  25273,  25273
226188,13084, 0.0000000, 0.0078740, 0.0078740,     0,   199,      0,  25273,  25273
226189,13084, 0.0000000, 0.0063704, 0.0063704,     0,   161,      0,  25273,  25273
226190,13084, 0.0000000, 0.0144423, 0.0144423,     0,   365,      0,  25273,  25273
226191,13084, 0.0000000, 0.0085862, 0.0085862,     0,   217,      0,  25273,  25273
226192,13030, 0.0000000, 0.0005235, 0.0002779,     0,    24,  40521,  45842,  86363
226193,13030, 0.0000000, 0.0055408, 0.0029411,     0,   254,  40521,  45842,  86363
226194,13030, 0.0000000, 0.0107325, 0.0056969,     0,   492,  40521,  45842,  86363
226195,13030, 0.0000000, 0.0115833, 0.0061485,     0,   531,  40521,  45842,  86363
226196,13015, 0.0000000, 0.0761481, 0.0734249,     0,  1353,    659,  17768,  18427
226197,13015, 1.0000000, 0.0165466, 0.0517176,   659,   294,    659,  17768,  18427
226198,13015, 0.0000000, 0.0374268, 0.0360883,     0,   665,    659,  17768,  18427
226199,13015, 0.0000000, 0.0191355, 0.0184512,     0,   340,    659,  17768,  18427
226201,13015, 0.0000000, 0.0074291, 0.0071634,     0,   132,    659,  17768,  18427
226202,13015, 0.0000000, 0.0050653, 0.0048841,     0,    90,    659,  17768,  18427
226204,13037, 0.0000000, 0.0029192, 0.0024973,     0,    54,   3125,  18498,  21623
226207,13037, 0.0000000, 0.0309763, 0.0264996,     0,   573,   3125,  18498,  21623
226208,13037, 0.0000000, 0.0531409, 0.0454609,     0,   983,   3125,  18498,  21623
226209,13037, 0.4185600, 0.0023246, 0.0624798,  1308,    43,   3125,  18498,  21623
226211,13037, 0.0000000, 0.0303817, 0.0259908,     0,   562,   3125,  18498,  21623
226212,13037, 0.0000000, 0.0034598, 0.0029598,     0,    64,   3125,  18498,  21623
226212,13081, 0.0000000, 0.0084837, 0.0024355,     0,    79,  23125,   9312,  32437
226213,13081, 0.0000000, 0.0360825, 0.0103585,     0,   336,  23125,   9312,  32437
226214,13081, 0.0000000, 0.0105241, 0.0030212,     0,    98,  23125,   9312,  32437
226215,13081, 0.0000000, 0.0961125, 0.0275919,     0,   895,  23125,   9312,  32437
226216,13036, 0.0000000, 0.0432974, 0.0355617,     0,   333,   1673,   7691,   9364
226219,30072, 0.0000000, 0.0016716, 0.0012521,     0,    26,   5211,  15554,  20765
226222,30170, 0.0000000, 0.0414170, 0.0370754,     0,   394,   1114,   9513,  10627
226222,30072, 0.0000000, 0.0052720, 0.0039490,     0,    82,   5211,  15554,  20765
226223,30170, 0.0296230, 0.0927152, 0.0861014,    33,   882,   1114,   9513,  10627
226224,30170, 0.0000000, 0.1207821, 0.1081208,     0,  1149,   1114,   9513,  10627
226225,30170, 0.0000000, 0.0174498, 0.0156206,     0,   166,   1114,   9513,  10627
226226,30170, 0.0000000, 0.0643330, 0.0575892,     0,   612,   1114,   9513,  10627
226227,30198, 0.0000000, 0.0030889, 0.0028007,     0,    19,    633,   6151,   6784
226228,30180, 0.0000000, 0.0209302, 0.0183576,     0,   207,   1386,   9890,  11276
226229,30180, 0.0000000, 0.0499494, 0.0438099,     0,   494,   1386,   9890,  11276
226230,30180, 0.0000000, 0.0092012, 0.0080702,     0,    91,   1386,   9890,  11276
226232,13027, 0.0000000, 0.0046592, 0.0036498,     0,    86,   5105,  18458,  23563
226232,13053, 0.0000000, 0.0039180, 0.0033633,     0,    61,   2568,  15569,  18137
226233,13027, 0.0000000, 0.0965435, 0.0756270,     0,  1782,   5105,  18458,  23563
226234,13027, 0.0000000, 0.0190703, 0.0149387,     0,   352,   5105,  18458,  23563
226235,30083, 0.0000000, 0.0073560, 0.0068246,     0,   340,   3599,  46221,  49820
226235,13027, 0.0000000, 0.0002709, 0.0002122,     0,     5,   5105,  18458,  23563
226236,30083, 0.0000000, 0.0048246, 0.0044761,     0,   223,   3599,  46221,  49820
226237,30083, 0.0000000, 0.0293806, 0.0272581,     0,  1358,   3599,  46221,  49820
226238,30083, 0.0000000, 0.0114450, 0.0106182,     0,   529,   3599,  46221,  49820
226239,21111, 0.0000000, 0.0280739, 0.0202875,     0,   374,   5113,  13322,  18435
226240,21111, 0.0000000, 0.0668819, 0.0483320,     0,   891,   5113,  13322,  18435
226241,21111, 0.0000000, 0.0260471, 0.0188229,     0,   347,   5113,  13322,  18435
226242,21111, 0.0000000, 0.0007506, 0.0005424,     0,    10,   5113,  13322,  18435
226243,21111, 0.0000000, 0.0216184, 0.0156225,     0,   288,   5113,  13322,  18435
226245,21194, 0.0000000, 0.0348603, 0.0086769,     0,   242,  20948,   6942,  27890
226245,21064, 0.0000000, 0.0007296, 0.0007296,     0,     9,      0,  12336,  12336
226248,30175, 0.0000000, 0.0103876, 0.0103876,     0,   506,      0,  48712,  48712
226249,30175, 0.0000000, 0.0035104, 0.0035104,     0,   171,      0,  48712,  48712
226250,30175, 0.0000000, 0.0056044, 0.0056044,     0,   273,      0,  48712,  48712
227220,22005, 0.0000000, 0.0000470, 0.0000344,     0,     2,  15623,  42548,  58171
227222,22005, 0.0000000, 0.0070039, 0.0051228,     0,   298,  15623,  42548,  58171
227223,22005, 0.0000000, 0.0436448, 0.0319231,     0,  1857,  15623,  42548,  58171
227224,22005, 0.0000000, 0.0396728, 0.0290179,     0,  1688,  15623,  42548,  58171
227226,22007, 0.0000000, 0.0173092, 0.0065840,     0,   251,  23622,  14501,  38123
227226,22005, 0.0000000, 0.0399549, 0.0292242,     0,  1700,  15623,  42548,  58171
227227,22007, 0.0000000, 0.0022757, 0.0008656,     0,    33,  23622,  14501,  38123
227227,22005, 0.0000000, 0.0217402, 0.0159014,     0,   925,  15623,  42548,  58171
227228,22007, 0.0000000, 0.0038618, 0.0014689,     0,    56,  23622,  14501,  38123
227229,22007, 0.4686733, 0.0744776, 0.3187315, 11071,  1080,  23622,  14501,  38123
227230,22007, 0.0000000, 0.1283360, 0.0488157,     0,  1861,  23622,  14501,  38123
227231,22007, 0.0836508, 0.0028274, 0.0529077,  1976,    41,  23622,  14501,  38123
227231,22004, 0.0000000, 0.0014598, 0.0014598,     0,    70,      0,  47952,  47952
227232,22007, 0.0000000, 0.0525481, 0.0199879,     0,   762,  23622,  14501,  38123
227236,22004, 0.0000000, 0.0049007, 0.0049007,     0,   235,      0,  47952,  47952
227237,22004, 0.0000000, 0.0091550, 0.0091550,     0,   439,      0,  47952,  47952
227239,22004, 0.0000000, 0.0029404, 0.0029404,     0,   141,      0,  47952,  47952
227241,22004, 0.0000000, 0.0003962, 0.0003962,     0,    19,      0,  47952,  47952
227244,13084, 0.0000000, 0.0086258, 0.0086258,     0,   218,      0,  25273,  25273
227245,13084, 0.0000000, 0.0214062, 0.0214062,     0,   541,      0,  25273,  25273
227246,13084, 0.0000000, 0.0146401, 0.0146401,     0,   370,      0,  25273,  25273
227247,13084, 0.0000000, 0.0049856, 0.0049856,     0,   126,      0,  25273,  25273
227248,13084, 0.0000000, 0.0039568, 0.0039568,     0,   100,      0,  25273,  25273
227249,13084, 0.0000000, 0.0130574, 0.0130574,     0,   330,      0,  25273,  25273
227250,13084, 0.0000000, 0.0341867, 0.0341867,     0,   864,      0,  25273,  25273
227251,13030, 0.0000000, 0.0048645, 0.0025821,     0,   223,  40521,  45842,  86363
227252,13030, 0.0000000, 0.0030103, 0.0015979,     0,   138,  40521,  45842,  86363
227253,13030, 0.0000000, 0.0093364, 0.0049558,     0,   428,  40521,  45842,  86363
227254,13030, 0.0000000, 0.0011780, 0.0006253,     0,    54,  40521,  45842,  86363
227254,13015, 0.0000000, 0.0076542, 0.0073805,     0,   136,    659,  17768,  18427
227255,13015, 0.0000000, 0.0921319, 0.0888370,     0,  1637,    659,  17768,  18427
227256,13015, 0.0000000, 0.0047839, 0.0046128,     0,    85,    659,  17768,  18427
227257,13015, 0.0000000, 0.0551553, 0.0531828,     0,   980,    659,  17768,  18427
227259,13015, 0.0000000, 0.0044462, 0.0042872,     0,    79,    659,  17768,  18427
227260,13071, 0.0000000, 0.0084998, 0.0084998,     0,    80,      0,   9412,   9412
227260,13015, 0.0000000, 0.0055155, 0.0053183,     0,    98,    659,  17768,  18427
227262,13037, 0.0000000, 0.0005947, 0.0005087,     0,    11,   3125,  18498,  21623
227263,13037, 0.0000000, 0.0066494, 0.0056884,     0,   123,   3125,  18498,  21623
227265,13037, 0.0000000, 0.0095145, 0.0081395,     0,   176,   3125,  18498,  21623
227266,13037, 0.0000000, 0.0555736, 0.0475420,     0,  1028,   3125,  18498,  21623
227267,13037, 0.0000000, 0.0897394, 0.0767701,     0,  1660,   3125,  18498,  21623
227268,13037, 0.0000000, 0.0217321, 0.0185913,     0,   402,   3125,  18498,  21623
227269,13037, 0.0000000, 0.0241648, 0.0206724,     0,   447,   3125,  18498,  21623
227270,13037, 0.0000000, 0.0258406, 0.0221061,     0,   478,   3125,  18498,  21623
227272,13081, 0.3601297, 0.0467139, 0.2701544,  8328,   435,  23125,   9312,  32437
227273,13081, 0.0200216, 0.0950387, 0.0415575,   463,   885,  23125,   9312,  32437
227274,13081, 0.0000000, 0.0090206, 0.0025896,     0,    84,  23125,   9312,  32437
227275,13081, 0.0000000, 0.0939648, 0.0269754,     0,   875,  23125,   9312,  32437
227276,13081, 0.0000000, 0.0236254, 0.0067824,     0,   220,  23125,   9312,  32437
227277,13081, 0.0000000, 0.0067655, 0.0019422,     0,    63,  23125,   9312,  32437
227278,30072, 0.0000000, 0.0035361, 0.0026487,     0,    55,   5211,  15554,  20765
227280,30072, 0.0000000, 0.0592131, 0.0443535,     0,   921,   5211,  15554,  20765
227281,30072, 0.0000000, 0.0223094, 0.0167108,     0,   347,   5211,  15554,  20765
227282,30170, 0.0000000, 0.0544518, 0.0487438,     0,   518,   1114,   9513,  10627
227285,30170, 0.0000000, 0.0467781, 0.0418745,     0,   445,   1114,   9513,  10627
227286,30170, 0.0000000, 0.0013666, 0.0012233,     0,    13,   1114,   9513,  10627
227287,30180, 0.0000000, 0.0002022, 0.0001774,     0,     2,   1386,   9890,  11276
227288,30180, 1.0000000, 0.0232558, 0.1433132,  1386,   230,   1386,   9890,  11276
227289,30180, 0.0000000, 0.0097068, 0.0085137,     0,    96,   1386,   9890,  11276
227290,30180, 0.0000000, 0.1746208, 0.1531571,     0,  1727,   1386,   9890,  11276
227291,13027, 0.0000000, 0.0033590, 0.0026312,     0,    62,   5105,  18458,  23563
227291,30083, 0.0000000, 0.0092599, 0.0085909,     0,   428,   3599,  46221,  49820
227292,13027, 0.0000000, 0.0046050, 0.0036074,     0,    85,   5105,  18458,  23563
227293,13027, 0.0000000, 0.0289847, 0.0227051,     0,   535,   5105,  18458,  23563
227294,30083, 0.0000000, 0.0105147, 0.0097551,     0,   486,   3599,  46221,  49820
227295,30083, 0.0000000, 0.0000865, 0.0000803,     0,     4,   3599,  46221,  49820
227296,30083, 0.0000000, 0.0106012, 0.0098354,     0,   490,   3599,  46221,  49820
227297,30083, 0.6457349, 0.0000433, 0.0466881,  2324,     2,   3599,  46221,  49820
227298,21111, 0.0000000, 0.0400841, 0.0289666,     0,   534,   5113,  13322,  18435
227298,30083, 0.0000000, 0.0070098, 0.0065034,     0,   324,   3599,  46221,  49820
227300,21064, 0.0000000, 0.0990597, 0.0990597,     0,  1222,      0,  12336,  12336
227301,21064, 0.0000000, 0.0831712, 0.0831712,     0,  1026,      0,  12336,  12336
227302,21064, 0.0000000, 0.0012970, 0.0012970,     0,    16,      0,  12336,  12336
227303,21064, 0.0000000, 0.0000811, 0.0000811,     0,     1,      0,  12336,  12336
227304,21064, 0.0000000, 0.0963035, 0.0963035,     0,  1188,      0,  12336,  12336
227305,21064, 0.0000000, 0.0749838, 0.0749838,     0,   925,      0,  12336,  12336
227305,30175, 0.0000000, 0.0196050, 0.0196050,     0,   955,      0,  48712,  48712
227306,30175, 0.0000000, 0.0090122, 0.0090122,     0,   439,      0,  48712,  48712
227307,30175, 0.0000000, 0.0009854, 0.0009854,     0,    48,      0,  48712,  48712
227308,30175, 0.0000000, 0.0194203, 0.0194203,     0,   946,      0,  48712,  48712
227309,30175, 0.0000000, 0.0136106, 0.0136106,     0,   663,      0,  48712,  48712
132988,12017, 0.4084761, 0.0000000, 0.1848100,  2718,     0,   6654,   8053,  14707
132993,12035, 0.0216002, 0.0000000, 0.0190649,  2676,     0, 123888,  16475, 140363
133032,21024, 0.0000000, 0.0000000, 0.0000000,     0,     0,    561,    386,    947
133036,21059, 0.0000000, 0.0000000, 0.0000000,     0,     0,   1420,   1048,   2468
134046,12017, 0.0565074, 0.0000000, 0.0255661,   376,     0,   6654,   8053,  14707
134054,12059, 0.0003262, 0.0000000, 0.0000985,     3,     0,   9196,  21274,  30470
134111,21190, 0.0087816, 0.0000000, 0.0069264,     8,     0,    911,    244,   1155
135118,12034, 0.0003009, 0.0000000, 0.0001873,     7,     0,  23262,  14102,  37364
135169,21190, 0.0285401, 0.0000000, 0.0225108,    26,     0,    911,    244,   1155
136171,12035, 0.0062557, 0.0000000, 0.0055214,   775,     0, 123888,  16475, 140363
136176,12034, 0.5998625, 0.0000000, 0.3734611, 13954,     0,  23262,  14102,  37364
136202,21047, 0.5871444, 0.0000000, 0.4424016,  8422,     0,  14344,   4693,  19037
136220,21003, 0.0010017, 0.0000000, 0.0005611,    19,     0,  18968,  14897,  33865
136221,21003, 0.1392872, 0.0000000, 0.0780156,  2642,     0,  18968,  14897,  33865
137253,21087, 0.0279123, 0.0000000, 0.0154794,   196,     0,   7022,   5640,  12662
138275,12058, 0.7176526, 0.0000000, 0.3143075, 16900,     0,  23549,  30220,  53769
138276,12058, 0.1072232, 0.0000000, 0.0469601,  2525,     0,  23549,  30220,  53769
138291,12034, 0.0918236, 0.0000000, 0.0571673,  2136,     0,  23262,  14102,  37364
138292,12034, 0.0034821, 0.0000000, 0.0021679,    81,     0,  23262,  14102,  37364
139375,21073, 0.0918773, 0.0000000, 0.0824980,   716,     0,   7793,    886,   8679
140465,21037, 0.1265432, 0.0000000, 0.0701154,   164,     0,   1296,   1043,   2339
141467,12015, 0.0011219, 0.0000000, 0.0006305,     8,     0,   7131,   5557,  12688
141469,12015, 0.0479596, 0.0000000, 0.0269546,   342,     0,   7131,   5557,  12688
141518,21147, 0.0302071, 0.0000000, 0.0208614,   124,     0,   4105,   1839,   5944
141523,21037, 0.0655864, 0.0000000, 0.0363403,    85,     0,   1296,   1043,   2339
142524,12055, 0.0000141, 0.0000000, 0.0000096,     1,     0,  70930,  33123, 104053
142528,12015, 0.0410882, 0.0000000, 0.0230927,   293,     0,   7131,   5557,  12688
142550,21073, 0.3116900, 0.0000000, 0.2798710,  2429,     0,   7793,    886,   8679
142551,21073, 0.0405492, 0.0000000, 0.0364097,   316,     0,   7793,    886,   8679
142552,21047, 0.0062047, 0.0000000, 0.0046751,    89,     0,  14344,   4693,  19037
143642,21082, 0.9252337, 0.0000000, 0.5627085,  4554,     0,   4922,   3171,   8093
144650,17012, 0.0000832, 0.0000000, 0.0000726,     4,     0,  48088,   7027,  55115
144689,21042, 0.0505050, 0.0000000, 0.0212280,    65,     0,   1287,   1775,   3062
145726,17003, 0.0217391, 0.0000000, 0.0163823,   552,     0,  25392,   8303,  33695
145727,17003, 0.0072464, 0.0000000, 0.0054608,   184,     0,  25392,   8303,  33695
145733,21051, 0.0057068, 0.0000000, 0.0034772,   118,     0,  20677,  13258,  33935
145735,21021, 0.0142476, 0.0000000, 0.0130293,    16,     0,   1123,    105,   1228
145736,21085, 0.0801045, 0.0000000, 0.0652619,  4751,     0,  59310,  13489,  72799
146785,17003, 0.0918399, 0.0000000, 0.0692091,  2332,     0,  25392,   8303,  33695
146804,21007, 0.5419104, 0.0000000, 0.1633852,   556,     0,   1026,   2377,   3403
147837,17004, 0.0001033, 0.0000000, 0.0000634,     5,     0,  48393,  30473,  78866
147845,17013, 0.0477665, 0.0000000, 0.0369762,   540,     0,  11305,   3299,  14604
147853,21176, 0.0308083, 0.0000000, 0.0101178,    85,     0,   2759,   5642,   8401
147855,21085, 0.3150733, 0.0000000, 0.2566931, 18687,     0,  59310,  13489,  72799
147856,21085, 0.1021750, 0.0000000, 0.0832429,  6060,     0,  59310,  13489,  72799
147866,21031, 0.0008917, 0.0000000, 0.0006748,     2,     0,   2243,    721,   2964
148886,17012, 0.0091707, 0.0000000, 0.0080015,   441,     0,  48088,   7027,  55115
148887,17012, 0.0055939, 0.0000000, 0.0048807,   269,     0,  48088,   7027,  55115
148890,17012, 0.0046581, 0.0000000, 0.0040642,   224,     0,  48088,   7027,  55115
148906,21168, 0.0007990, 0.0000000, 0.0007599,     5,     0,   6258,    322,   6580
148907,21168, 0.0004794, 0.0000000, 0.0004559,     3,     0,   6258,    322,   6580
148909,21168, 0.0441035, 0.0000000, 0.0419453,   276,     0,   6258,    322,   6580
148913,21085, 0.0111617, 0.0000000, 0.0090935,   662,     0,  59310,  13489,  72799
148928,21206, 0.5873016, 0.0000000, 0.1489110,   629,     0,   1071,   3153,   4224
148928,21146, 0.9313501, 0.0000000, 0.9313501,   814,     0,    874,      0,    874
148942,21177, 0.0257309, 0.0000000, 0.0152068,   734,     0,  28526,  19742,  48268
149966,21168, 0.0853308, 0.0000000, 0.0811550,   534,     0,   6258,    322,   6580
149967,21168, 0.3491531, 0.0000000, 0.3320669,  2185,     0,   6258,    322,   6580
149977,21201, 0.0101083, 0.0000000, 0.0043928,    14,     0,   1385,   1802,   3187
149978,21133, 0.2989045, 0.0000000, 0.2933948,   191,     0,    639,     12,    651
149987,21146, 0.0686499, 0.0000000, 0.0686499,    60,     0,    874,      0,    874
149987,21052, 0.7681633, 0.0000000, 0.7669111,   941,     0,   1225,      2,   1227
151032,21085, 0.0114989, 0.0000000, 0.0093683,   682,     0,  59310,  13489,  72799
151036,21133, 0.0046948, 0.0000000, 0.0046083,     3,     0,    639,     12,    651
151037,21201, 0.0014440, 0.0000000, 0.0006275,     2,     0,   1385,   1802,   3187
151037,21133, 0.0109546, 0.0000000, 0.0107527,     7,     0,    639,     12,    651
151046,21052, 0.2318367, 0.0000000, 0.2314588,   284,     0,   1225,      2,   1227
151047,21070, 0.0046838, 0.0000000, 0.0006021,     4,     0,    854,   5789,   6643
151060,21177, 0.0451868, 0.0000000, 0.0267051,  1289,     0,  28526,  19742,  48268
151061,21177, 0.0341793, 0.0000000, 0.0201997,   975,     0,  28526,  19742,  48268
152060,17015, 0.0037410, 0.0000000, 0.0024410,    61,     0,  16306,   8684,  24990
152072,17004, 0.0052074, 0.0000000, 0.0031953,   252,     0,  48393,  30473,  78866
152081,17010, 0.0232582, 0.0000000, 0.0147642,   231,     0,   9932,   5714,  15646
152098,21159, 0.0354371, 0.0000000, 0.0260934,   105,     0,   2963,   1061,   4024
152115,21203, 0.0125564, 0.0000000, 0.0105803,    64,     0,   5097,    952,   6049
152120,21177, 0.1989063, 0.0000000, 0.1175520,  5674,     0,  28526,  19742,  48268
153144,21165, 0.4956085, 0.0000000, 0.3461876,   395,     0,    797,    344,   1141
153145,21165, 0.4993727, 0.0000000, 0.3488168,   398,     0,    797,    344,   1141
153175,21203, 0.2609378, 0.0000000, 0.2198711,  1330,     0,   5097,    952,   6049
154185,17008, 0.0001640, 0.0000000, 0.0001557,    13,     0,  79279,   4206,  83485
154199,17032, 0.0029141, 0.0000000, 0.0027512,    25,     0,   8579,    508,   9087
154222,21095, 0.2644628, 0.0000000, 0.2644628,   128,     0,    484,      0,    484
154224,21131, 0.1318807, 0.0000000, 0.1318807,   115,     0,    872,      0,    872
154225,21131, 0.8681192, 0.0000000, 0.8681192,   757,     0,    872,      0,    872
155241,17018, 0.0005734, 0.0000000, 0.0005364,    58,     0, 101159,   6967, 108126
155242,17018, 0.0028371, 0.0000000, 0.0026543,   287,     0, 101159,   6967, 108126
155258,17033, 0.0012157, 0.0000000, 0.0010928,    16,     0,  13161,   1480,  14641
155281,21095, 0.7355372, 0.0000000, 0.7355372,   356,     0,    484,      0,    484
156299,17028, 0.1690558, 0.0000000, 0.1315515,  8338,     0,  49321,  14061,  63382
156300,17018, 0.3186568, 0.0000000, 0.2981244, 32235,     0, 101159,   6967, 108126
156312,17006, 0.0009227, 0.0000000, 0.0008333,   146,     0, 158225,  16982, 175207
156320,21022, 0.0015989, 0.0000000, 0.0010270,    12,     0,   7505,   4179,  11684
156347,21171, 0.0023229, 0.0000000, 0.0017831,     6,     0,   2583,    782,   3365
156348,21079, 0.0262089, 0.0000000, 0.0133811,    71,     0,   2709,   2597,   5306
156356,21205, 0.0679797, 0.0000000, 0.0512274,  1177,     0,  17314,   5662,  22976
157333,15080, 0.5952712, 0.0000000, 0.0829168,  2140,     0,   3595,  22214,  25809
157356,17018, 0.0299232, 0.0000000, 0.0279951,  3027,     0, 101159,   6967, 108126
157360,17007, 0.0006808, 0.0000000, 0.0006545,   239,     0, 351048,  14120, 365168
157361,17011, 0.0324586, 0.0000000, 0.0312511,  6155,     0, 189626,   7327, 196953
157380,21022, 0.0227848, 0.0000000, 0.0146354,   171,     0,   7505,   4179,  11684
157382,21022, 0.0720853, 0.0000000, 0.0463026,   541,     0,   7505,   4179,  11684
157383,21022, 0.0154564, 0.0000000, 0.0099281,   116,     0,   7505,   4179,  11684
157384,21022, 0.0290473, 0.0000000, 0.0186580,   218,     0,   7505,   4179,  11684
157406,21171, 0.1022067, 0.0000000, 0.0784547,   264,     0,   2583,    782,   3365
157409,21154, 0.0035649, 0.0000000, 0.0027805,   199,     0,  55822,  15749,  71571
157414,21205, 0.0421624, 0.0000000, 0.0317723,   730,     0,  17314,   5662,  22976
157415,21205, 0.0016749, 0.0000000, 0.0012622,    29,     0,  17314,   5662,  22976
158395,15004, 0.0000000, 0.0000000, 0.0000000,     0,     0,   3153,  11703,  14856
158415,17018, 0.0034006, 0.0000000, 0.0031815,   344,     0, 101159,   6967, 108126
158418,17007, 0.0219315, 0.0000000, 0.0210834,  7699,     0, 351048,  14120, 365168
158419,17018, 0.0005437, 0.0000000, 0.0005087,    55,     0, 101159,   6967, 108126
158419,17011, 0.0232774, 0.0000000, 0.0224114,  4414,     0, 189626,   7327, 196953
158419,17008, 0.1037601, 0.0000000, 0.0985327,  8226,     0,  79279,   4206,  83485
158419,17007, 0.0162342, 0.0000000, 0.0156065,  5699,     0, 351048,  14120, 365168
158420,17008, 0.0070510, 0.0000000, 0.0066958,   559,     0,  79279,   4206,  83485
158422,17029, 0.1040208, 0.0000000, 0.0862645,  8439,     0,  81128,  16699,  97827
158428,17029, 0.0070013, 0.0000000, 0.0058062,   568,     0,  81128,  16699,  97827
158429,17006, 0.1060389, 0.0000000, 0.0957610, 16778,     0, 158225,  16982, 175207
158433,17030, 0.0232804, 0.0000000, 0.0160012,   749,     0,  32173,  14636,  46809
158436,21188, 0.0632881, 0.0000000, 0.0309490,   527,     0,   8327,   8701,  17028
158437,21188, 0.2483487, 0.0000000, 0.1214470,  2068,     0,   8327,   8701,  17028
158442,21022, 0.2215856, 0.0000000, 0.1423314,  1663,     0,   7505,   4179,  11684
158465,21153, 0.0696282, 0.0000000, 0.0327133,   663,     0,   9522,  10745,  20267
158468,21154, 0.0007703, 0.0000000, 0.0006008,    43,     0,  55822,  15749,  71571
159478,17011, 0.0321686, 0.0000000, 0.0309719,  6100,     0, 189626,   7327, 196953
159478,17007, 0.0881475, 0.0000000, 0.0847391, 30944,     0, 351048,  14120, 365168
159479,17011, 0.2309968, 0.0000000, 0.2224033, 43803,     0, 189626,   7327, 196953
159479,17007, 0.0090159, 0.0000000, 0.0086672,  3165,     0, 351048,  14120, 365168
159487,17002, 0.0619311, 0.0000000, 0.0349299,   660,     0,  10657,   8238,  18895
159491,17030, 0.0046312, 0.0000000, 0.0031831,   149,     0,  32173,  14636,  46809
159494,17022, 0.0035378, 0.0000000, 0.0030829,    59,     0,  16677,   2461,  19138
159496,17022, 0.2140073, 0.0000000, 0.1864876,  3569,     0,  16677,   2461,  19138
159496,21188, 0.0279813, 0.0000000, 0.0136833,   233,     0,   8327,   8701,  17028
159512,21114, 0.0002387, 0.0000000, 0.0002338,   360,     0,1507901,  31918,1539819
159524,21153, 0.0009452, 0.0000000, 0.0004441,     9,     0,   9522,  10745,  20267
159524,21097, 0.0006925, 0.0000000, 0.0004513,     1,     0,   1444,    772,   2216
159525,21189, 0.0215748, 0.0000000, 0.0168012,   331,     0,  15342,   4359,  19701
159526,21151, 0.2185264, 0.0000000, 0.2171906,  1741,     0,   7967,     49,   8016
159531,21154, 0.0010748, 0.0000000, 0.0008383,    60,     0,  55822,  15749,  71571
160518,15021, 0.0592806, 0.0000000, 0.0113894,   412,     0,   6950,  29224,  36174
160536,17007, 0.1523495, 0.0000000, 0.1464586, 53482,     0, 351048,  14120, 365168
160537,17007, 0.1029289, 0.0000000, 0.0989490, 36133,     0, 351048,  14120, 365168
160538,17011, 0.1554639, 0.0000000, 0.1496804, 29480,     0, 189626,   7327, 196953
160539,17011, 0.0220223, 0.0000000, 0.0212030,  4176,     0, 189626,   7327, 196953
160554,17022, 0.0167896, 0.0000000, 0.0146306,   280,     0,  16677,   2461,  19138
160579,21153, 0.0059861, 0.0000000, 0.0028125,    57,     0,   9522,  10745,  20267
160584,21164, 0.0023215, 0.0000000, 0.0015929,   119,     0,  51259,  23449,  74708
160585,21189, 0.0142745, 0.0000000, 0.0111162,   219,     0,  15342,   4359,  19701
160587,21154, 0.0111963, 0.0000000, 0.0087326,   625,     0,  55822,  15749,  71571
160591,21115, 0.0942904, 0.0000000, 0.0764578,  3615,     0,  38339,   8942,  47281
160592,21115, 0.3098412, 0.0000000, 0.2512426, 11879,     0,  38339,   8942,  47281
161581,15088, 0.1047318, 0.0000000, 0.0503046,  4575,     0,  43683,  47263,  90946
161595,17007, 0.1197215, 0.0000000, 0.1150922, 42028,     0, 351048,  14120, 365168
161598,17020, 0.0757229, 0.0000000, 0.0397559,  1655,     0,  21856,  19773,  41629
161603,17026, 0.0008762, 0.0000000, 0.0004231,     7,     0,   7989,   8554,  16543
161610,15015, 0.0860903, 0.0000000, 0.0777934,  2152,     0,  24997,   2666,  27663
161612,15034, 0.6277983, 0.0000000, 0.4729427,  4431,     0,   7058,   2311,   9369
161618,21019, 0.0000100, 0.0000000, 0.0000079,     1,     0,  99856,  27206, 127062
161621,21019, 0.0010315, 0.0000000, 0.0008106,   103,     0,  99856,  27206, 127062
161631,21114, 0.0001373, 0.0000000, 0.0001344,   207,     0,1507901,  31918,1539819
161642,21164, 0.0883747, 0.0000000, 0.0606361,  4530,     0,  51259,  23449,  74708
161647,21154, 0.0335710, 0.0000000, 0.0261838,  1874,     0,  55822,  15749,  71571
162638,15113, 0.0433089, 0.0000000, 0.0122352,   734,     0,  16948,  43043,  59991
162644,15088, 0.0401987, 0.0000000, 0.0193082,  1756,     0,  43683,  47263,  90946
162672,15034, 0.0141683, 0.0000000, 0.0106735,   100,     0,   7058,   2311,   9369
162678,21019, 0.0026538, 0.0000000, 0.0020856,   265,     0,  99856,  27206, 127062
162687,21119, 0.0000805, 0.0000000, 0.0000797,     8,     0,  99359,   1080, 100439
162687,21114, 0.0001572, 0.0000000, 0.0001539,   237,     0,1507901,  31918,1539819
162688,21114, 0.0350527, 0.0000000, 0.0343261, 52856,     0,1507901,  31918,1539819
162704,21004, 0.0800496, 0.0000000, 0.0657283,  3423,     0,  42761,   9317,  52078
162705,21118, 0.0062907, 0.0000000, 0.0057136,   146,     0,  23209,   2344,  25553
163712,17007, 0.0000199, 0.0000000, 0.0000192,     7,     0, 351048,  14120, 365168
163726,15094, 0.0005140, 0.0000000, 0.0004365,     8,     0,  15563,   2764,  18327
163728,15015, 0.0003600, 0.0000000, 0.0003253,     9,     0,  24997,   2666,  27663
163740,21175, 0.0001928, 0.0000000, 0.0001020,     1,     0,   5187,   4620,   9807
163741,21175, 0.0173511, 0.0000000, 0.0091771,    90,     0,   5187,   4620,   9807
163745,21125, 0.1059586, 0.0000000, 0.1020808,   834,     0,   7871,    299,   8170
163746,21114, 0.0000743, 0.0000000, 0.0000727,   112,     0,1507901,  31918,1539819
163747,21119, 0.0422810, 0.0000000, 0.0418264,  4201,     0,  99359,   1080, 100439
163747,21114, 0.0208270, 0.0000000, 0.0203953, 31405,     0,1507901,  31918,1539819
163748,21114, 0.0701770, 0.0000000, 0.0687224,105820,     0,1507901,  31918,1539819
163749,21114, 0.0466609, 0.0000000, 0.0456937, 70360,     0,1507901,  31918,1539819
163766,21065, 0.0596023, 0.0000000, 0.0541492,  1031,     0,  17298,   1742,  19040
163768,21065, 0.0024280, 0.0000000, 0.0022059,    42,     0,  17298,   1742,  19040
163769,21115, 0.0000261, 0.0000000, 0.0000212,     1,     0,  38339,   8942,  47281
164762,15049, 0.3025383, 0.0000000, 0.2060748,  2646,     0,   8746,   4094,  12840
164788,15068, 0.1972751, 0.0000000, 0.1420958,  3866,     0,  19597,   7610,  27207
164800,21102, 0.0040809, 0.0000000, 0.0039131,    47,     0,  11517,    494,  12011
164801,21140, 0.0006776, 0.0000000, 0.0006724,    81,     0, 119547,    912, 120459
164803,21119, 0.0108294, 0.0000000, 0.0107130,  1076,     0,  99359,   1080, 100439
164804,21125, 0.1819337, 0.0000000, 0.1752754,  1432,     0,   7871,    299,   8170
164806,21119, 0.2796526, 0.0000000, 0.2766455, 27786,     0,  99359,   1080, 100439
164806,21114, 0.0015226, 0.0000000, 0.0014911,  2296,     0,1507901,  31918,1539819
164807,21119, 0.0001510, 0.0000000, 0.0001493,    15,     0,  99359,   1080, 100439
164807,21114, 0.0302566, 0.0000000, 0.0296295, 45624,     0,1507901,  31918,1539819
164808,21114, 0.0435778, 0.0000000, 0.0426745, 65711,     0,1507901,  31918,1539819
164809,21114, 0.0418635, 0.0000000, 0.0409957, 63126,     0,1507901,  31918,1539819
164813,21015, 0.0000103, 0.0000000, 0.0000099,     1,     0,  96882,   4082, 100964
164816,21001, 0.0247804, 0.0000000, 0.0229483,  1385,     0,  55891,   4462,  60353
164817,21001, 0.0084987, 0.0000000, 0.0078704,   475,     0,  55891,   4462,  60353
164821,21118, 0.0002154, 0.0000000, 0.0001957,     5,     0,  23209,   2344,  25553
164821,21004, 0.0547461, 0.0000000, 0.0449518,  2341,     0,  42761,   9317,  52078
164825,21065, 0.2120476, 0.0000000, 0.1926471,  3668,     0,  17298,   1742,  19040
165820,15090, 0.0192973, 0.0000000, 0.0155326,  1211,     0,  62755,  15210,  77965
165846,15068, 0.1297648, 0.0000000, 0.0934686,  2543,     0,  19597,   7610,  27207
165847,15068, 0.1626780, 0.0000000, 0.1171757,  3188,     0,  19597,   7610,  27207
165848,15015, 0.0395647, 0.0000000, 0.0357517,   989,     0,  24997,   2666,  27663
165857,21138, 0.0295981, 0.0000000, 0.0290433,   313,     0,  10575,    202,  10777
165858,21138, 0.0005674, 0.0000000, 0.0005567,     6,     0,  10575,    202,  10777
165860,21102, 0.0309108, 0.0000000, 0.0296395,   356,     0,  11517,    494,  12011
165862,21119, 0.0217293, 0.0000000, 0.0214956,  2159,     0,  99359,   1080, 100439
165863,21140, 0.1261847, 0.0000000, 0.1252293, 15085,     0, 119547,    912, 120459
165864,21140, 0.0273533, 0.0000000, 0.0271462,  3270,     0, 119547,    912, 120459
165864,21114, 0.0000099, 0.0000000, 0.0000097,    15,     0,1507901,  31918,1539819
165865,21140, 0.0050273, 0.0000000, 0.0049892,   601,     0, 119547,    912, 120459
165865,21119, 0.1150173, 0.0000000, 0.1137805, 11428,     0,  99359,   1080, 100439
165865,21114, 0.0188686, 0.0000000, 0.0184775, 28452,     0,1507901,  31918,1539819
165866,21114, 0.0287147, 0.0000000, 0.0281195, 43299,     0,1507901,  31918,1539819
165867,21114, 0.0404887, 0.0000000, 0.0396495, 61053,     0,1507901,  31918,1539819
165868,21114, 0.0452669, 0.0000000, 0.0443286, 68258,     0,1507901,  31918,1539819
165869,21114, 0.0568174, 0.0000000, 0.0556397, 85675,     0,1507901,  31918,1539819
165870,21114, 0.0151250, 0.0000000, 0.0148115, 22807,     0,1507901,  31918,1539819
165886,21065, 0.0379235, 0.0000000, 0.0344538,   656,     0,  17298,   1742,  19040
166876,15090, 0.0111864, 0.0000000, 0.0090040,   702,     0,  62755,  15210,  77965
166879,15090, 0.0291929, 0.0000000, 0.0234977,  1832,     0,  62755,  15210,  77965
166880,15090, 0.0270098, 0.0000000, 0.0217405,  1695,     0,  62755,  15210,  77965
166908,15009, 0.0496169, 0.0000000, 0.0390533,  1891,     0,  38112,  10309,  48421
166917,21138, 0.0012293, 0.0000000, 0.0012063,    13,     0,  10575,    202,  10777
166918,21102, 0.0295216, 0.0000000, 0.0283074,   340,     0,  11517,    494,  12011
166923,21140, 0.2260701, 0.0000000, 0.2243585, 27026,     0, 119547,    912, 120459
166923,21119, 0.0220614, 0.0000000, 0.0218242,  2192,     0,  99359,   1080, 100439
166924,21140, 0.1391419, 0.0000000, 0.1380885, 16634,     0, 119547,    912, 120459
166924,21114, 0.0128390, 0.0000000, 0.0125729, 19360,     0,1507901,  31918,1539819
166924,21041, 0.1251078, 0.0000000, 0.1154599,  9139,     0,  73049,   6104,  79153
166925,21114, 0.0431394, 0.0000000, 0.0422452, 65050,     0,1507901,  31918,1539819
166925,21041, 0.0140454, 0.0000000, 0.0129622,  1026,     0,  73049,   6104,  79153
166926,21114, 0.0446899, 0.0000000, 0.0437636, 67388,     0,1507901,  31918,1539819
166927,21114, 0.0527395, 0.0000000, 0.0516463, 79526,     0,1507901,  31918,1539819
166928,21114, 0.0390251, 0.0000000, 0.0382162, 58846,     0,1507901,  31918,1539819
166932,21015, 0.0714993, 0.0000000, 0.0686086,  6927,     0,  96882,   4082, 100964
167935,15090, 0.0527926, 0.0000000, 0.0424934,  3313,     0,  62755,  15210,  77965
167937,15090, 0.0795634, 0.0000000, 0.0640416,  4993,     0,  62755,  15210,  77965
167939,15090, 0.0089395, 0.0000000, 0.0071955,   561,     0,  62755,  15210,  77965
167951,9012 , 0.0024223, 0.0000000, 0.0023887,  1554,     0, 641550,   9017, 650567
167974,21026, 0.2195517, 0.0000000, 0.1975965,  2713,     0,  12357,   1373,  13730
167975,21026, 0.2054706, 0.0000000, 0.1849235,  2539,     0,  12357,   1373,  13730
167979,21090, 0.1179510, 0.0000000, 0.1157497,  2146,     0,  18194,    346,  18540
167980,21090, 0.2721776, 0.0000000, 0.2670982,  4952,     0,  18194,    346,  18540
167981,21140, 0.0651292, 0.0000000, 0.0646361,  7786,     0, 119547,    912, 120459
167981,21034, 0.0468473, 0.0000000, 0.0451208,  1561,     0,  33321,   1275,  34596
167982,21140, 0.0110919, 0.0000000, 0.0110079,  1326,     0, 119547,    912, 120459
167982,21041, 0.0754836, 0.0000000, 0.0696625,  5514,     0,  73049,   6104,  79153
167983,21041, 0.3190872, 0.0000000, 0.2944803, 23309,     0,  73049,   6104,  79153
167983,21034, 0.0050719, 0.0000000, 0.0048850,   169,     0,  33321,   1275,  34596
167984,21114, 0.0201320, 0.0000000, 0.0197147, 30357,     0,1507901,  31918,1539819
167985,21114, 0.0374594, 0.0000000, 0.0366829, 56485,     0,1507901,  31918,1539819
167986,21114, 0.0324464, 0.0000000, 0.0317739, 48926,     0,1507901,  31918,1539819
167986,29025, 0.0955068, 0.0000000, 0.0943475,  6568,     0,  68770,    845,  69615
167987,29025, 0.0125200, 0.0000000, 0.0123680,   861,     0,  68770,    845,  69615
167994,21163, 0.0023624, 0.0000000, 0.0023349,    38,     0,  16085,    190,  16275
167994,21001, 0.0741980, 0.0000000, 0.0687124,  4147,     0,  55891,   4462,  60353
168002,21004, 0.0016838, 0.0000000, 0.0013825,    72,     0,  42761,   9317,  52078
168976,15110, 0.0510982, 0.0000000, 0.0257959,  1589,     0,  31097,  30502,  61599
168996,15073, 0.5157925, 0.0000000, 0.4865475, 10778,     0,  20896,   1256,  22152
168999,15101, 0.0011090, 0.0000000, 0.0007215,    51,     0,  45986,  24696,  70682
169023,15009, 0.0053264, 0.0000000, 0.0041924,   203,     0,  38112,  10309,  48421
169042,21034, 0.0876624, 0.0000000, 0.0844317,  2921,     0,  33321,   1275,  34596
169043,21114, 0.0041959, 0.0000000, 0.0041089,  6327,     0,1507901,  31918,1539819
169043,29041, 0.0032037, 0.0000000, 0.0031855,    86,     0,  26844,    153,  26997
169043,29027, 0.0120316, 0.0000000, 0.0119017,   140,     0,  11636,    127,  11763
169045,21114, 0.0003899, 0.0000000, 0.0003819,   588,     0,1507901,  31918,1539819
169060,21152, 0.0006110, 0.0000000, 0.0003417,     4,     0,   6547,   5159,  11706
169061,21096, 0.0771930, 0.0000000, 0.0417774,   110,     0,   1425,   1208,   2633
169062,21152, 0.0610967, 0.0000000, 0.0341705,   400,     0,   6547,   5159,  11706
170035,15110, 0.2081230, 0.0000000, 0.1050666,  6472,     0,  31097,  30502,  61599
170036,15110, 0.3902306, 0.0000000, 0.1970000, 12135,     0,  31097,  30502,  61599
170058,15019, 0.0542344, 0.0000000, 0.0481511,  1642,     0,  30276,   3825,  34101
170058,15006, 0.1180183, 0.0000000, 0.1030682,  1122,     0,   9507,   1379,  10886
170059,15019, 0.3637204, 0.0000000, 0.3229231, 11012,     0,  30276,   3825,  34101
170060,15101, 0.1667899, 0.0000000, 0.1085142,  7670,     0,  45986,  24696,  70682
170092,21074, 0.0031478, 0.0000000, 0.0023796,   151,     0,  47970,  15487,  63457
170093,21074, 0.0632062, 0.0000000, 0.0477804,  3032,     0,  47970,  15487,  63457
170094,21060, 0.0054570, 0.0000000, 0.0046070,    32,     0,   5864,   1082,   6946
170095,21060, 0.0000000, 0.0000000, 0.0000000,     0,     0,   5864,   1082,   6946
170099,21136, 0.5973911, 0.0000000, 0.5804449,  6732,     0,  11269,    329,  11598
170099,21034, 0.1078299, 0.0000000, 0.1038559,  3593,     0,  33321,   1275,  34596
170101,29042, 0.0158303, 0.0000000, 0.0158303,   194,     0,  12255,      0,  12255
170102,21041, 0.1285028, 0.0000000, 0.1185931,  9387,     0,  73049,   6104,  79153
170102,29042, 0.1900449, 0.0000000, 0.1900449,  2329,     0,  12255,      0,  12255
170102,29041, 0.3253986, 0.0000000, 0.3235545,  8735,     0,  26844,    153,  26997
170102,29027, 0.0001719, 0.0000000, 0.0001700,     2,     0,  11636,    127,  11763
170103,29041, 0.2368872, 0.0000000, 0.2355447,  6359,     0,  26844,    153,  26997
170107,29025, 0.0129271, 0.0000000, 0.0127702,   889,     0,  68770,    845,  69615
170121,21152, 0.0540706, 0.0000000, 0.0302409,   354,     0,   6547,   5159,  11706
171111,15054, 0.0000384, 0.0000000, 0.0000374,     8,     0, 208332,   5830, 214162
171113,15054, 0.0023280, 0.0000000, 0.0022646,   485,     0, 208332,   5830, 214162
171117,15101, 0.1488062, 0.0000000, 0.0968139,  6843,     0,  45986,  24696,  70682
171129,9013 , 0.0005075, 0.0000000, 0.0004988,   207,     0, 407885,   7122, 415007
171135,15025, 0.0205448, 0.0000000, 0.0197562,  6127,     0, 298226,  11904, 310130
171152,21048, 0.1351286, 0.0000000, 0.1190172,  2233,     0,  16525,   2237,  18762
171154,21048, 0.0038729, 0.0000000, 0.0034112,    64,     0,  16525,   2237,  18762
171157,21181, 0.4515429, 0.0000000, 0.4318073,  2707,     0,   5995,    274,   6269
171158,21181, 0.0026689, 0.0000000, 0.0025522,    16,     0,   5995,    274,   6269
171160,29042, 0.0196654, 0.0000000, 0.0196654,   241,     0,  12255,      0,  12255
171161,29058, 0.2333584, 0.0000000, 0.2333584,  1865,     0,   7992,      0,   7992
171161,29044, 0.1281131, 0.0000000, 0.1274900,  4928,     0,  38466,    188,  38654
171161,29042, 0.7743778, 0.0000000, 0.7743778,  9490,     0,  12255,      0,  12255
171161,29041, 0.0204142, 0.0000000, 0.0202986,   548,     0,  26844,    153,  26997
171162,29058, 0.1031031, 0.0000000, 0.1031031,   824,     0,   7992,      0,   7992
171162,29027, 0.0000000, 0.0000000, 0.0000000,     0,     0,  11636,    127,  11763
171162,29017, 0.3755558, 0.0000000, 0.3728953,  3632,     0,   9671,     69,   9740
171163,29027, 0.0000000, 0.0000000, 0.0000000,     0,     0,  11636,    127,  11763
171173,21104, 0.0498635, 0.0000000, 0.0354683,   968,     0,  19413,   7879,  27292
172166,15118, 0.0551859, 0.0000000, 0.0410291,  6883,     0, 124724,  43035, 167759
172168,15118, 0.0330249, 0.0000000, 0.0245531,  4119,     0, 124724,  43035, 167759
172170,15054, 0.0000000, 0.0000000, 0.0000000,     0,     0, 208332,   5830, 214162
172174,15076, 0.0606325, 0.0000000, 0.0602240,  4371,     0,  72090,    489,  72579
172175,15076, 0.0798030, 0.0000000, 0.0792653,  5753,     0,  72090,    489,  72579
172176,15062, 0.0003292, 0.0000000, 0.0002589,    16,     0,  48605,  13200,  61805
172193,9013 , 0.0001250, 0.0000000, 0.0001229,    51,     0, 407885,   7122, 415007
172194,9009 , 0.0287165, 0.0000000, 0.0250417,  3270,     0, 113872,  16710, 130582
172194,15025, 0.0008785, 0.0000000, 0.0008448,   262,     0, 298226,  11904, 310130
172195,15025, 0.0061665, 0.0000000, 0.0059298,  1839,     0, 298226,  11904, 310130
172199,15103, 0.0005328, 0.0000000, 0.0004119,    19,     0,  35659,  10471,  46130
172200,15025, 0.0240086, 0.0000000, 0.0230871,  7160,     0, 298226,  11904, 310130
172210,21048, 0.1298638, 0.0000000, 0.1143801,  2146,     0,  16525,   2237,  18762
172213,21048, 0.0000000, 0.0000000, 0.0000000,     0,     0,  16525,   2237,  18762
172220,29059, 0.8112233, 0.0000000, 0.5740153,  3614,     0,   4455,   1841,   6296
172220,29058, 0.2291041, 0.0000000, 0.2291041,  1831,     0,   7992,      0,   7992
172220,29054, 0.0025964, 0.0000000, 0.0025768,    13,     0,   5007,     38,   5045
172220,29044, 0.4738470, 0.0000000, 0.4715424, 18227,     0,  38466,    188,  38654
172221,29058, 0.4345596, 0.0000000, 0.4345596,  3473,     0,   7992,      0,   7992
172221,29041, 0.1362688, 0.0000000, 0.1354965,  3658,     0,  26844,    153,  26997
172222,29041, 0.0042095, 0.0000000, 0.0041857,   113,     0,  26844,    153,  26997
172234,21104, 0.0318859, 0.0000000, 0.0226806,   619,     0,  19413,   7879,  27292
173214,15032, 0.1150323, 0.0000000, 0.0330294,  1105,     0,   9606,  23849,  33455
173215,15032, 0.0326879, 0.0000000, 0.0093857,   314,     0,   9606,  23849,  33455
173222,15118, 0.0005131, 0.0000000, 0.0003815,    64,     0, 124724,  43035, 167759
173227,15106, 0.0118438, 0.0000000, 0.0109595,  8982,     0, 758370,  61191, 819561
173229,15106, 0.0940280, 0.0000000, 0.0870076, 71308,     0, 758370,  61191, 819561
173230,15106, 0.0302372, 0.0000000, 0.0279796, 22931,     0, 758370,  61191, 819561
173230,15054, 0.1638394, 0.0000000, 0.1593793, 34133,     0, 208332,   5830, 214162
173231,15106, 0.0040350, 0.0000000, 0.0037337,  3060,     0, 758370,  61191, 819561
173231,15054, 0.3196245, 0.0000000, 0.3109235, 66588,     0, 208332,   5830, 214162
173232,15076, 0.0387987, 0.0000000, 0.0385373,  2797,     0,  72090,    489,  72579
173232,15054, 0.1235912, 0.0000000, 0.1202267, 25748,     0, 208332,   5830, 214162
173233,15054, 0.0117121, 0.0000000, 0.0113932,  2440,     0, 208332,   5830, 214162
173234,15076, 0.1823693, 0.0000000, 0.1811406, 13147,     0,  72090,    489,  72579
173234,15051, 0.1650262, 0.0000000, 0.0971372, 13094,     0,  79345,  55454, 134799
173237,15062, 0.0753215, 0.0000000, 0.0592347,  3661,     0,  48605,  13200,  61805
173239,15062, 0.0001646, 0.0000000, 0.0001294,     8,     0,  48605,  13200,  61805
173244,9008 , 0.0012834, 0.0000000, 0.0012799,   306,     0, 238431,    655, 239086
173246,9012 , 0.0913382, 0.0000000, 0.0900722, 58598,     0, 641550,   9017, 650567
173247,9012 , 0.0285636, 0.0000000, 0.0281677, 18325,     0, 641550,   9017, 650567
173248,9013 , 0.1957071, 0.0000000, 0.1923486, 79826,     0, 407885,   7122, 415007
173251,9011 , 0.0068282, 0.0000000, 0.0067534,  2433,     0, 356315,   3950, 360265
173252,9013 , 0.0257376, 0.0000000, 0.0252960, 10498,     0, 407885,   7122, 415007
173255,15122, 0.0010495, 0.0000000, 0.0010457,   374,     0, 356352,   1293, 357645
173274,21074, 0.0000000, 0.0000000, 0.0000000,     0,     0,  47970,  15487,  63457
173274,29019, 0.0131966, 0.0000000, 0.0124433,   233,     0,  17656,   1069,  18725
173275,29019, 0.0000000, 0.0000000, 0.0000000,     0,     0,  17656,   1069,  18725
173276,29032, 0.0215677, 0.0000000, 0.0141015,   175,     0,   8114,   4296,  12410
173278,29054, 0.5504294, 0.0000000, 0.5462834,  2756,     0,   5007,     38,   5045
173278,29044, 0.0005199, 0.0000000, 0.0005174,    20,     0,  38466,    188,  38654
173278,29032, 0.0112152, 0.0000000, 0.0073328,    91,     0,   8114,   4296,  12410
173278,29029, 0.0068259, 0.0000000, 0.0019913,    22,     0,   3223,   7825,  11048
173279,29054, 0.0948672, 0.0000000, 0.0941526,   475,     0,   5007,     38,   5045
173279,29053, 0.0343951, 0.0000000, 0.0337194,   230,     0,   6687,    134,   6821
173279,29044, 0.0683981, 0.0000000, 0.0680654,  2631,     0,  38466,    188,  38654
173279,29028, 0.0989285, 0.0000000, 0.0860597,  1865,     0,  18852,   2819,  21671
173280,29060, 0.0193868, 0.0000000, 0.0193868,    86,     0,   4436,      0,   4436
173280,29028, 0.3963505, 0.0000000, 0.3447926,  7472,     0,  18852,   2819,  21671
173293,21104, 0.3234946, 0.0000000, 0.2301041,  6280,     0,  19413,   7879,  27292
173294,21117, 0.7154853, 0.0000000, 0.7154853, 10054,     0,  14052,      0,  14052
174285,15005, 0.0058526, 0.0000000, 0.0023433,   346,     0,  59119,  88534, 147653
174286,15106, 0.0001530, 0.0000000, 0.0001415,   116,     0, 758370,  61191, 819561
174287,15118, 0.0175187, 0.0000000, 0.0130246,  2185,     0, 124724,  43035, 167759
174287,15106, 0.0578491, 0.0000000, 0.0535299, 43871,     0, 758370,  61191, 819561
174288,15106, 0.0857695, 0.0000000, 0.0793657, 65045,     0, 758370,  61191, 819561
174289,15106, 0.0590253, 0.0000000, 0.0546183, 44763,     0, 758370,  61191, 819561
174290,15106, 0.0298693, 0.0000000, 0.0276392, 22652,     0, 758370,  61191, 819561
174290,15054, 0.0660772, 0.0000000, 0.0642784, 13766,     0, 208332,   5830, 214162
174291,15106, 0.0224653, 0.0000000, 0.0207880, 17037,     0, 758370,  61191, 819561
174291,15076, 0.0206964, 0.0000000, 0.0205569,  1492,     0,  72090,    489,  72579
174291,15054, 0.0413331, 0.0000000, 0.0402079,  8611,     0, 208332,   5830, 214162
174291,15051, 0.0000000, 0.0000000, 0.0000000,     0,     0,  79345,  55454, 134799
174292,15106, 0.0007384, 0.0000000, 0.0006833,   560,     0, 758370,  61191, 819561
174292,15076, 0.2029824, 0.0000000, 0.2016148, 14633,     0,  72090,    489,  72579
174292,15051, 0.0184889, 0.0000000, 0.0108829,  1467,     0,  79345,  55454, 134799
174295,15051, 0.0145441, 0.0000000, 0.0085609,  1154,     0,  79345,  55454, 134799
174302,9012 , 0.0005814, 0.0000000, 0.0005733,   373,     0, 641550,   9017, 650567
174303,9012 , 0.1771787, 0.0000000, 0.1747230,113669,     0, 641550,   9017, 650567
174304,9012 , 0.0932273, 0.0000000, 0.0919352, 59810,     0, 641550,   9017, 650567
174305,9012 , 0.1470548, 0.0000000, 0.1450166, 94343,     0, 641550,   9017, 650567
174306,9013 , 0.0316217, 0.0000000, 0.0310790, 12898,     0, 407885,   7122, 415007
174306,9012 , 0.0781856, 0.0000000, 0.0771020, 50160,     0, 641550,   9017, 650567
174306,9003 , 0.0003304, 0.0000000, 0.0003304,   205,     0, 620416,      0, 620416
174307,9013 , 0.1159935, 0.0000000, 0.1140029, 47312,     0, 407885,   7122, 415007
174307,9012 , 0.0574265, 0.0000000, 0.0566306, 36842,     0, 641550,   9017, 650567
174308,9007 , 0.0042428, 0.0000000, 0.0042428,  7704,     0,1815786,      0,1815786
174309,9011 , 0.1562438, 0.0000000, 0.1545307, 55672,     0, 356315,   3950, 360265
174309,9007 , 0.0149731, 0.0000000, 0.0149731, 27188,     0,1815786,      0,1815786
174313,15122, 0.3852118, 0.0000000, 0.3838192,137271,     0, 356352,   1293, 357645
174314,15122, 0.1812141, 0.0000000, 0.1805589, 64576,     0, 356352,   1293, 357645
174314,15039, 0.0117189, 0.0000000, 0.0115072,  5378,     0, 458917,   8444, 467361
174314,15025, 0.1754274, 0.0000000, 0.1686938, 52317,     0, 298226,  11904, 310130
174315,15039, 0.0046239, 0.0000000, 0.0045404,  2122,     0, 458917,   8444, 467361
174316,15039, 0.0058072, 0.0000000, 0.0057022,  2665,     0, 458917,   8444, 467361
174317,15039, 0.0157458, 0.0000000, 0.0154613,  7226,     0, 458917,   8444, 467361
174317,15025, 0.0588513, 0.0000000, 0.0565924, 17551,     0, 298226,  11904, 310130
174318,15025, 0.0054891, 0.0000000, 0.0052784,  1637,     0, 298226,  11904, 310130
174326,21180, 0.0157980, 0.0000000, 0.0111726,   408,     0,  25826,  10692,  36518
174329,21132, 0.0054373, 0.0000000, 0.0053078,   749,     0, 137752,   3360, 141112
174332,29019, 0.1120865, 0.0000000, 0.1056876,  1979,     0,  17656,   1069,  18725
174337,29053, 0.0017945, 0.0000000, 0.0017593,    12,     0,   6687,    134,   6821
174337,29033, 0.0141251, 0.0000000, 0.0141211,  1268,     0,  89769,     26,  89795
174338,29060, 0.1814698, 0.0000000, 0.1814698,   805,     0,   4436,      0,   4436
174338,29033, 0.0381980, 0.0000000, 0.0381870,  3429,     0,  89769,     26,  89795
174339,29060, 0.7585663, 0.0000000, 0.7585663,  3365,     0,   4436,      0,   4436
174339,29050, 0.0061879, 0.0000000, 0.0061741,    61,     0,   9858,     22,   9880
174339,29048, 0.2496139, 0.0000000, 0.2496139,  4202,     0,  16834,      0,  16834
174339,29028, 0.0384044, 0.0000000, 0.0334087,   724,     0,  18852,   2819,  21671
174340,29050, 0.7385880, 0.0000000, 0.7369433,  7281,     0,   9858,     22,   9880
174340,29048, 0.0960556, 0.0000000, 0.0960556,  1617,     0,  16834,      0,  16834
174340,29010, 0.0038539, 0.0000000, 0.0035828,   237,     0,  61496,   4653,  66149
174352,21117, 0.2839454, 0.0000000, 0.2839454,  3990,     0,  14052,      0,  14052
174353,21117, 0.0000000, 0.0000000, 0.0000000,     0,     0,  14052,      0,  14052
174355,21128, 0.0010371, 0.0000000, 0.0006183,     5,     0,   4821,   3266,   8087
175329,15032, 0.0284197, 0.0000000, 0.0081602,   273,     0,   9606,  23849,  33455
175343,15118, 0.0006254, 0.0000000, 0.0004650,    78,     0, 124724,  43035, 167759
175344,15005, 0.0172533, 0.0000000, 0.0069081,  1020,     0,  59119,  88534, 147653
175345,15005, 0.0001353, 0.0000000, 0.0000542,     8,     0,  59119,  88534, 147653
175348,15106, 0.0658887, 0.0000000, 0.0609692, 49968,     0, 758370,  61191, 819561
175349,15106, 0.0592574, 0.0000000, 0.0548330, 44939,     0, 758370,  61191, 819561
175350,15106, 0.0421575, 0.0000000, 0.0390099, 31971,     0, 758370,  61191, 819561
175350,15051, 0.0000000, 0.0000000, 0.0000000,     0,     0,  79345,  55454, 134799
175352,15106, 0.0000593, 0.0000000, 0.0000549,    45,     0, 758370,  61191, 819561
175352,15051, 0.0084063, 0.0000000, 0.0049481,   667,     0,  79345,  55454, 134799
175361,9008 , 0.5017468, 0.0000000, 0.5003722,119632,     0, 238431,    655, 239086
175362,9012 , 0.0228665, 0.0000000, 0.0225496, 14670,     0, 641550,   9017, 650567
175362,9010 , 0.0031032, 0.0000000, 0.0031016,  2255,     0, 726664,    370, 727034
175362,9008 , 0.2985602, 0.0000000, 0.2977422, 71186,     0, 238431,    655, 239086
175363,9012 , 0.0075037, 0.0000000, 0.0073997,  4814,     0, 641550,   9017, 650567
175363,9010 , 0.0121900, 0.0000000, 0.0121837,  8858,     0, 726664,    370, 727034
175363,9008 , 0.0002349, 0.0000000, 0.0002342,    56,     0, 238431,    655, 239086
175363,9003 , 0.0043197, 0.0000000, 0.0043197,  2680,     0, 620416,      0, 620416
175364,9012 , 0.0273697, 0.0000000, 0.0269903, 17559,     0, 641550,   9017, 650567
175364,9003 , 0.1467548, 0.0000000, 0.1467548, 91049,     0, 620416,      0, 620416
175365,9012 , 0.0158896, 0.0000000, 0.0156694, 10194,     0, 641550,   9017, 650567
175365,9003 , 0.1683451, 0.0000000, 0.1683451,104444,     0, 620416,      0, 620416
175366,9013 , 0.0000000, 0.0000000, 0.0000000,     0,     0, 407885,   7122, 415007
175366,9012 , 0.0270517, 0.0000000, 0.0266767, 17355,     0, 641550,   9017, 650567
175366,9007 , 0.0001751, 0.0000000, 0.0001751,   318,     0,1815786,      0,1815786
175366,9003 , 0.1732966, 0.0000000, 0.1732966,107516,     0, 620416,      0, 620416
175367,9013 , 0.0000098, 0.0000000, 0.0000096,     4,     0, 407885,   7122, 415007
175367,9003 , 0.0037862, 0.0000000, 0.0037862,  2349,     0, 620416,      0, 620416
175367,9012 , 0.0000639, 0.0000000, 0.0000630,    41,     0, 641550,   9017, 650567
175367,9007 , 0.0604229, 0.0000000, 0.0604229,109715,     0,1815786,      0,1815786
175368,9011 , 0.1450655, 0.0000000, 0.1434749, 51689,     0, 356315,   3950, 360265
175368,9007 , 0.0543836, 0.0000000, 0.0543836, 98749,     0,1815786,      0,1815786
175369,9007 , 0.0162828, 0.0000000, 0.0162828, 29566,     0,1815786,      0,1815786
175371,15122, 0.0097151, 0.0000000, 0.0096800,  3462,     0, 356352,   1293, 357645
175372,15122, 0.2764205, 0.0000000, 0.2754212, 98503,     0, 356352,   1293, 357645
175372,15039, 0.0331411, 0.0000000, 0.0325423, 15209,     0, 458917,   8444, 467361
175373,15122, 0.0140984, 0.0000000, 0.0140474,  5024,     0, 356352,   1293, 357645
175373,15039, 0.1952793, 0.0000000, 0.1917511, 89617,     0, 458917,   8444, 467361
175378,15039, 0.0000893, 0.0000000, 0.0000877,    41,     0, 458917,   8444, 467361
175385,21180, 0.0983892, 0.0000000, 0.0695821,  2541,     0,  25826,  10692,  36518
175387,21180, 0.0441803, 0.0000000, 0.0312449,  1141,     0,  25826,  10692,  36518
175387,21134, 0.0005626, 0.0000000, 0.0004143,     8,     0,  14220,   5090,  19310
175388,21134, 0.0003516, 0.0000000, 0.0002589,     5,     0,  14220,   5090,  19310
175388,21132, 0.0089581, 0.0000000, 0.0087448,  1234,     0, 137752,   3360, 141112
175389,21143, 0.0374255, 0.0000000, 0.0320208,   910,     0,  24315,   4104,  28419
175391,29015, 0.0041068, 0.0000000, 0.0029009,   102,     0,  24837,  10325,  35162
175394,29056, 0.1171145, 0.0000000, 0.1169608,   802,     0,   6848,      9,   6857
175395,29049, 0.3359825, 0.0000000, 0.3339258,  1691,     0,   5033,     31,   5064
175395,29033, 0.0223128, 0.0000000, 0.0223064,  2003,     0,  89769,     26,  89795
175395,29024, 0.0023175, 0.0000000, 0.0013531,    34,     0,  14671,  10457,  25128
175396,29033, 0.0857980, 0.0000000, 0.0857731,  7702,     0,  89769,     26,  89795
175396,29024, 0.0000682, 0.0000000, 0.0000398,     1,     0,  14671,  10457,  25128
175397,29060, 0.0371957, 0.0000000, 0.0371957,   165,     0,   4436,      0,   4436
175397,29048, 0.0007722, 0.0000000, 0.0007722,    13,     0,  16834,      0,  16834
175397,29033, 0.1894864, 0.0000000, 0.1894315, 17010,     0,  89769,     26,  89795
175397,29010, 0.0033823, 0.0000000, 0.0031444,   208,     0,  61496,   4653,  66149
175398,29060, 0.0033814, 0.0000000, 0.0033814,    15,     0,   4436,      0,   4436
175398,29048, 0.5222169, 0.0000000, 0.5222169,  8791,     0,  16834,      0,  16834
175398,29033, 0.0072408, 0.0000000, 0.0072387,   650,     0,  89769,     26,  89795
175398,29010, 0.0759074, 0.0000000, 0.0705680,  4668,     0,  61496,   4653,  66149
175399,29048, 0.1313413, 0.0000000, 0.1313413,  2211,     0,  16834,      0,  16834
175411,21117, 0.0004981, 0.0000000, 0.0004981,     7,     0,  14052,      0,  14052
175412,29008, 0.0005954, 0.0000000, 0.0003657,     5,     0,   8398,   5273,  13671
175413,29008, 0.1405097, 0.0000000, 0.0863141,  1180,     0,   8398,   5273,  13671
176388,15032, 0.0006246, 0.0000000, 0.0001793,     6,     0,   9606,  23849,  33455
176389,15032, 0.0129086, 0.0000000, 0.0037065,   124,     0,   9606,  23849,  33455
176404,15005, 0.0601160, 0.0000000, 0.0240699,  3554,     0,  59119,  88534, 147653
176407,15106, 0.0436713, 0.0000000, 0.0404107, 33119,     0, 758370,  61191, 819561
176408,15106, 0.0365916, 0.0000000, 0.0338596, 27750,     0, 758370,  61191, 819561
176414,15051, 0.0019913, 0.0000000, 0.0011721,   158,     0,  79345,  55454, 134799
176417,9004 , 0.0070289, 0.0000000, 0.0069209,  1290,     0, 183528,   2863, 186391
176418,15037, 0.0024590, 0.0000000, 0.0021514,   521,     0, 211875,  30292, 242167
176419,9010 , 0.0152478, 0.0000000, 0.0152400, 11080,     0, 726664,    370, 727034
176419,9004 , 0.1459559, 0.0000000, 0.1437140, 26787,     0, 183528,   2863, 186391
176420,9010 , 0.0632686, 0.0000000, 0.0632364, 45975,     0, 726664,    370, 727034
176420,9008 , 0.0101497, 0.0000000, 0.0101219,  2420,     0, 238431,    655, 239086
176420,9004 , 0.0278159, 0.0000000, 0.0273887,  5105,     0, 183528,   2863, 186391
176421,9010 , 0.0958710, 0.0000000, 0.0958222, 69666,     0, 726664,    370, 727034
176421,9008 , 0.0399696, 0.0000000, 0.0398601,  9530,     0, 238431,    655, 239086
176422,9010 , 0.0500383, 0.0000000, 0.0500128, 36361,     0, 726664,    370, 727034
176422,9008 , 0.0255839, 0.0000000, 0.0255138,  6100,     0, 238431,    655, 239086
176422,9003 , 0.0039216, 0.0000000, 0.0039216,  2433,     0, 620416,      0, 620416
176423,9010 , 0.0029918, 0.0000000, 0.0029902,  2174,     0, 726664,    370, 727034
176423,9003 , 0.1809173, 0.0000000, 0.1809173,112244,     0, 620416,      0, 620416
176424,9003 , 0.1463067, 0.0000000, 0.1463067, 90771,     0, 620416,      0, 620416
176425,9007 , 0.0371833, 0.0000000, 0.0371833, 67517,     0,1815786,      0,1815786
176425,9003 , 0.1330817, 0.0000000, 0.1330817, 82566,     0, 620416,      0, 620416
176426,9007 , 0.0663586, 0.0000000, 0.0663586,120493,     0,1815786,      0,1815786
176427,9007 , 0.1044996, 0.0000000, 0.1044996,189749,     0,1815786,      0,1815786
176428,9007 , 0.1060268, 0.0000000, 0.1060268,192522,     0,1815786,      0,1815786
176429,9007 , 0.0741398, 0.0000000, 0.0741398,134622,     0,1815786,      0,1815786
176430,9007 , 0.0212057, 0.0000000, 0.0212057, 38505,     0,1815786,      0,1815786
176430,15122, 0.0089013, 0.0000000, 0.0088691,  3172,     0, 356352,   1293, 357645
176430,15070, 0.0786042, 0.0000000, 0.0780004, 19800,     0, 251895,   1950, 253845
176431,15122, 0.0217650, 0.0000000, 0.0216863,  7756,     0, 356352,   1293, 357645
176431,15070, 0.1134639, 0.0000000, 0.1125923, 28581,     0, 251895,   1950, 253845
176431,15039, 0.0859850, 0.0000000, 0.0844315, 39460,     0, 458917,   8444, 467361
176437,15039, 0.0056546, 0.0000000, 0.0055525,  2595,     0, 458917,   8444, 467361
176438,15039, 0.0009196, 0.0000000, 0.0009029,   422,     0, 458917,   8444, 467361
176448,21143, 0.0202755, 0.0000000, 0.0173476,   493,     0,  24315,   4104,  28419
176450,29019, 0.0112710, 0.0000000, 0.0106275,   199,     0,  17656,   1069,  18725
176452,29056, 0.0848423, 0.0000000, 0.0847309,   581,     0,   6848,      9,   6857
176454,29036, 0.0464884, 0.0000000, 0.0247758,   511,     0,  10992,   9633,  20625
176455,29033, 0.1324622, 0.0000000, 0.1324238, 11891,     0,  89769,     26,  89795
176455,29024, 0.1955559, 0.0000000, 0.1141754,  2869,     0,  14671,  10457,  25128
176456,29033, 0.3692923, 0.0000000, 0.3691854, 33151,     0,  89769,     26,  89795
176456,29010, 0.0225381, 0.0000000, 0.0209527,  1386,     0,  61496,   4653,  66149
176457,29033, 0.0700130, 0.0000000, 0.0699928,  6285,     0,  89769,     26,  89795
176457,29018, 0.0122202, 0.0000000, 0.0105176,   369,     0,  30196,   4888,  35084
176457,29010, 0.5363601, 0.0000000, 0.4986319, 32984,     0,  61496,   4653,  66149
176457,29002, 0.2693593, 0.0000000, 0.2171245,  2901,     0,  10770,   2591,  13361
176458,29018, 0.3332561, 0.0000000, 0.2868259, 10063,     0,  30196,   4888,  35084
176461,29026, 0.0167634, 0.0000000, 0.0130232,   234,     0,  13959,   4009,  17968
176471,29008, 0.0003572, 0.0000000, 0.0002194,     3,     0,   8398,   5273,  13671
176476,29007, 0.1030248, 0.0000000, 0.0955232,  1468,     0,  14249,   1119,  15368
176477,29007, 0.0000000, 0.0000000, 0.0000000,     0,     0,  14249,   1119,  15368
177467,15067, 0.0692882, 0.0000000, 0.0347683,  2717,     0,  39213,  38933,  78146
177468,15067, 0.0624283, 0.0000000, 0.0313260,  2448,     0,  39213,  38933,  78146
177478,9004 , 0.3443943, 0.0000000, 0.3391044, 63206,     0, 183528,   2863, 186391
177478,15037, 0.0937770, 0.0000000, 0.0820467, 19869,     0, 211875,  30292, 242167
177479,9010 , 0.0683851, 0.0000000, 0.0683503, 49693,     0, 726664,    370, 727034
177479,9004 , 0.0449632, 0.0000000, 0.0442725,  8252,     0, 183528,   2863, 186391
177480,9010 , 0.2175916, 0.0000000, 0.2174809,158116,     0, 726664,    370, 727034
177481,9010 , 0.1557474, 0.0000000, 0.1556681,113176,     0, 726664,    370, 727034
177481,9014 , 0.0358915, 0.0000000, 0.0358915, 13834,     0, 385439,      0, 385439
177482,9010 , 0.0107010, 0.0000000, 0.0106955,  7776,     0, 726664,    370, 727034
177482,9003 , 0.0084782, 0.0000000, 0.0084782,  5260,     0, 620416,      0, 620416
177482,9014 , 0.1999642, 0.0000000, 0.1999642, 77074,     0, 385439,      0, 385439
177483,9007 , 0.0163968, 0.0000000, 0.0163968, 29773,     0,1815786,      0,1815786
177483,9006 , 0.0049906, 0.0000000, 0.0049906,  1918,     0, 384326,      0, 384326
177483,9003 , 0.0188551, 0.0000000, 0.0188551, 11698,     0, 620416,      0, 620416
177483,9014 , 0.2115224, 0.0000000, 0.2115224, 81529,     0, 385439,      0, 385439
177484,9007 , 0.0672855, 0.0000000, 0.0672855,122176,     0,1815786,      0,1815786
177484,9006 , 0.0054381, 0.0000000, 0.0054381,  2090,     0, 384326,      0, 384326
177484,9003 , 0.0116035, 0.0000000, 0.0116035,  7199,     0, 620416,      0, 620416
177485,9007 , 0.0522920, 0.0000000, 0.0522920, 94951,     0,1815786,      0,1815786
177486,9007 , 0.0736579, 0.0000000, 0.0736579,133747,     0,1815786,      0,1815786
177487,9007 , 0.0751350, 0.0000000, 0.0751350,136429,     0,1815786,      0,1815786
177488,9007 , 0.0618305, 0.0000000, 0.0618305,112271,     0,1815786,      0,1815786
177488,15070, 0.0557851, 0.0000000, 0.0553566, 14052,     0, 251895,   1950, 253845
177488,15058, 0.0299216, 0.0000000, 0.0297605, 33051,     0,1104585,   5980,1110565
177489,9007 , 0.0000220, 0.0000000, 0.0000220,    40,     0,1815786,      0,1815786
177489,15070, 0.3885111, 0.0000000, 0.3855266, 97864,     0, 251895,   1950, 253845
177489,15058, 0.0233572, 0.0000000, 0.0232314, 25800,     0,1104585,   5980,1110565
177489,15031, 0.0019465, 0.0000000, 0.0019399,  1192,     0, 612383,   2070, 614453
177491,15031, 0.0002139, 0.0000000, 0.0002132,   131,     0, 612383,   2070, 614453
177492,15031, 0.0000555, 0.0000000, 0.0000553,    34,     0, 612383,   2070, 614453
177499,15039, 0.0088055, 0.0000000, 0.0086464,  4041,     0, 458917,   8444, 467361
177504,21134, 0.0868495, 0.0000000, 0.0639565,  1235,     0,  14220,   5090,  19310
177510,29015, 0.0158232, 0.0000000, 0.0111768,   393,     0,  24837,  10325,  35162
177516,29033, 0.0287182, 0.0000000, 0.0287098,  2578,     0,  89769,     26,  89795
177516,29018, 0.0476553, 0.0000000, 0.0410158,  1439,     0,  30196,   4888,  35084
177516,29001, 0.0000000, 0.0000000, 0.0000000,     0,     0,   9114,    761,   9875
177517,29026, 0.0214915, 0.0000000, 0.0166963,   300,     0,  13959,   4009,  17968
177517,29018, 0.4164459, 0.0000000, 0.3584255, 12575,     0,  30196,   4888,  35084
177517,29002, 0.0847725, 0.0000000, 0.0683332,   913,     0,  10770,   2591,  13361
177517,29001, 0.7613562, 0.0000000, 0.7026836,  6939,     0,   9114,    761,   9875
177518,29001, 0.0413649, 0.0000000, 0.0381772,   377,     0,   9114,    761,   9875
177520,29026, 0.0003582, 0.0000000, 0.0002783,     5,     0,  13959,   4009,  17968
177521,29052, 0.6697640, 0.0000000, 0.6367491,  3604,     0,   5381,    279,   5660
177522,29052, 0.0230440, 0.0000000, 0.0219081,   124,     0,   5381,    279,   5660
177534,29007, 0.0313004, 0.0000000, 0.0290213,   446,     0,  14249,   1119,  15368
177535,29007, 0.7411748, 0.0000000, 0.6872072, 10561,     0,  14249,   1119,  15368
177536,29007, 0.0756544, 0.0000000, 0.0701458,  1078,     0,  14249,   1119,  15368
178525,15106, 0.0000000, 0.0000000, 0.0000000,     0,     0, 758370,  61191, 819561
178528,15067, 0.0565119, 0.0000000, 0.0283572,  2216,     0,  39213,  38933,  78146
178529,15115, 0.3705323, 0.0000000, 0.2506098, 11611,     0,  31336,  14995,  46331
178530,15115, 0.0743554, 0.0000000, 0.0502903,  2330,     0,  31336,  14995,  46331
178533,15037, 0.0004814, 0.0000000, 0.0004212,   102,     0, 211875,  30292, 242167
178537,9004 , 0.0095244, 0.0000000, 0.0093781,  1748,     0, 183528,   2863, 186391
178537,15037, 0.2576425, 0.0000000, 0.2254147, 54588,     0, 211875,  30292, 242167
178538,9016 , 0.0219315, 0.0000000, 0.0219315,  8178,     0, 372889,      0, 372889
178538,9010 , 0.0027014, 0.0000000, 0.0027000,  1963,     0, 726664,    370, 727034
178538,9004 , 0.1018046, 0.0000000, 0.1002409, 18684,     0, 183528,   2863, 186391
178538,15037, 0.0345204, 0.0000000, 0.0302023,  7314,     0, 211875,  30292, 242167
178539,9016 , 0.0202875, 0.0000000, 0.0202875,  7565,     0, 372889,      0, 372889
178539,9010 , 0.0877200, 0.0000000, 0.0876754, 63743,     0, 726664,    370, 727034
178540,9016 , 0.0763927, 0.0000000, 0.0763927, 28486,     0, 372889,      0, 372889
178540,9010 , 0.1542790, 0.0000000, 0.1542005,112109,     0, 726664,    370, 727034
178540,9014 , 0.0311619, 0.0000000, 0.0311619, 12011,     0, 385439,      0, 385439
178541,9016 , 0.0692163, 0.0000000, 0.0692163, 25810,     0, 372889,      0, 372889
178541,9015 , 0.0255739, 0.0000000, 0.0255739, 13601,     0, 531831,      0, 531831
178541,9014 , 0.2273071, 0.0000000, 0.2273071, 87613,     0, 385439,      0, 385439
178542,9015 , 0.0254066, 0.0000000, 0.0254066, 13512,     0, 531831,      0, 531831
178542,9006 , 0.0605476, 0.0000000, 0.0605476, 23270,     0, 384326,      0, 384326
178542,9014 , 0.2941581, 0.0000000, 0.2941581,113380,     0, 385439,      0, 385439
178543,9017 , 0.0033760, 0.0000000, 0.0033760,  1455,     0, 430978,      0, 430978
178543,9015 , 0.0014873, 0.0000000, 0.0014873,   791,     0, 531831,      0, 531831
178543,9007 , 0.0090694, 0.0000000, 0.0090694, 16468,     0,1815786,      0,1815786
178543,9006 , 0.4035506, 0.0000000, 0.4035506,155095,     0, 384326,      0, 384326
178544,9007 , 0.0146477, 0.0000000, 0.0146477, 26597,     0,1815786,      0,1815786
178544,9006 , 0.2381312, 0.0000000, 0.2381312, 91520,     0, 384326,      0, 384326
178545,9007 , 0.0416910, 0.0000000, 0.0416910, 75702,     0,1815786,      0,1815786
178545,9006 , 0.1420071, 0.0000000, 0.1420071, 54577,     0, 384326,      0, 384326
178545,15058, 0.0309202, 0.0000000, 0.0307537, 34154,     0,1104585,   5980,1110565
178546,9007 , 0.0271855, 0.0000000, 0.0271855, 49363,     0,1815786,      0,1815786
178546,15058, 0.1232318, 0.0000000, 0.1225682,136120,     0,1104585,   5980,1110565
178547,9007 , 0.0008922, 0.0000000, 0.0008922,  1620,     0,1815786,      0,1815786
178547,15058, 0.1854054, 0.0000000, 0.1844070,204796,     0,1104585,   5980,1110565
178548,15070, 0.0138867, 0.0000000, 0.0137801,  3498,     0, 251895,   1950, 253845
178548,15058, 0.0572097, 0.0000000, 0.0569017, 63193,     0,1104585,   5980,1110565
178548,15031, 0.1169219, 0.0000000, 0.1165280, 71601,     0, 612383,   2070, 614453
178549,15070, 0.1071002, 0.0000000, 0.1062775, 26978,     0, 251895,   1950, 253845
178549,15029, 0.0927081, 0.0000000, 0.0915780, 16031,     0, 172919,   2134, 175053
178550,15070, 0.0087259, 0.0000000, 0.0086588,  2198,     0, 251895,   1950, 253845
178550,15031, 0.0540740, 0.0000000, 0.0538918, 33114,     0, 612383,   2070, 614453
178551,15031, 0.0054002, 0.0000000, 0.0053820,  3307,     0, 612383,   2070, 614453
178563,21134, 0.0029536, 0.0000000, 0.0021750,    42,     0,  14220,   5090,  19310
178573,29024, 0.0447822, 0.0000000, 0.0261461,   657,     0,  14671,  10457,  25128
178576,29026, 0.0237123, 0.0000000, 0.0184216,   331,     0,  13959,   4009,  17968
178576,29005, 0.0011635, 0.0000000, 0.0011243,    86,     0,  73914,   2578,  76492
178576,29002, 0.0008357, 0.0000000, 0.0006736,     9,     0,  10770,   2591,  13361
178576,29001, 0.1840026, 0.0000000, 0.1698228,  1677,     0,   9114,    761,   9875
178577,29038, 0.0100142, 0.0000000, 0.0082130,   120,     0,  11983,   2628,  14611
178577,29005, 0.0107422, 0.0000000, 0.0103802,   794,     0,  73914,   2578,  76492
178577,29001, 0.0072416, 0.0000000, 0.0066835,    66,     0,   9114,    761,   9875
178578,29038, 0.2718017, 0.0000000, 0.2229142,  3257,     0,  11983,   2628,  14611
178578,29026, 0.0450605, 0.0000000, 0.0350067,   629,     0,  13959,   4009,  17968
178578,29009, 0.2856624, 0.0000000, 0.1553494,   787,     0,   2755,   2311,   5066
178579,29009, 0.1245009, 0.0000000, 0.0677063,   343,     0,   2755,   2311,   5066
178580,29052, 0.0018584, 0.0000000, 0.0017668,    10,     0,   5381,    279,   5660
178580,29039, 0.0051469, 0.0000000, 0.0047315,   103,     0,  20012,   1757,  21769
178581,29052, 0.0022301, 0.0000000, 0.0021201,    12,     0,   5381,    279,   5660
178581,29039, 0.0047971, 0.0000000, 0.0044099,    96,     0,  20012,   1757,  21769
178582,29035, 0.0000000, 0.0000000, 0.0000000,     0,     0,   5564,     25,   5589
179581,15106, 0.0000435, 0.0000000, 0.0000403,    33,     0, 758370,  61191, 819561
179596,15057, 0.0220503, 0.0000000, 0.0214050, 17847,     0, 809377,  24402, 833779
179596,15037, 0.1440236, 0.0000000, 0.1260081, 30515,     0, 211875,  30292, 242167
179597,9016 , 0.0006275, 0.0000000, 0.0006275,   234,     0, 372889,      0, 372889
179597,15057, 0.0347131, 0.0000000, 0.0336972, 28096,     0, 809377,  24402, 833779
179597,15037, 0.1508201, 0.0000000, 0.1319544, 31955,     0, 211875,  30292, 242167
179598,9016 , 0.0639413, 0.0000000, 0.0639413, 23843,     0, 372889,      0, 372889
179598,15057, 0.0221701, 0.0000000, 0.0215213, 17944,     0, 809377,  24402, 833779
179598,15037, 0.0016755, 0.0000000, 0.0014659,   355,     0, 211875,  30292, 242167
179599,9016 , 0.0961064, 0.0000000, 0.0961064, 35837,     0, 372889,      0, 372889
179600,9016 , 0.0285232, 0.0000000, 0.0285232, 10636,     0, 372889,      0, 372889
179600,9015 , 0.1345897, 0.0000000, 0.1345897, 71579,     0, 531831,      0, 531831
179601,9017 , 0.0020395, 0.0000000, 0.0020395,   879,     0, 430978,      0, 430978
179601,9015 , 0.2684180, 0.0000000, 0.2684180,142753,     0, 531831,      0, 531831
179602,9006 , 0.0017147, 0.0000000, 0.0017147,   659,     0, 384326,      0, 384326
179602,9017 , 0.2767891, 0.0000000, 0.2767891,119290,     0, 430978,      0, 430978
179602,9015 , 0.0108794, 0.0000000, 0.0108794,  5786,     0, 531831,      0, 531831
179603,9017 , 0.1779604, 0.0000000, 0.1779604, 76697,     0, 430978,      0, 430978
179603,9006 , 0.0287959, 0.0000000, 0.0287959, 11067,     0, 384326,      0, 384326
179604,9017 , 0.1012209, 0.0000000, 0.1012209, 43624,     0, 430978,      0, 430978
179604,9006 , 0.1148322, 0.0000000, 0.1148322, 44133,     0, 384326,      0, 384326
179604,15058, 0.0949415, 0.0000000, 0.0944303,104871,     0,1104585,   5980,1110565
179606,15031, 0.0257633, 0.0000000, 0.0256765, 15777,     0, 612383,   2070, 614453
179607,15058, 0.0000878, 0.0000000, 0.0000873,    97,     0,1104585,   5980,1110565
179608,15031, 0.1440047, 0.0000000, 0.1435195, 88186,     0, 612383,   2070, 614453
179608,15029, 0.0152904, 0.0000000, 0.0151040,  2644,     0, 172919,   2134, 175053
179609,15099, 0.0069030, 0.0000000, 0.0063661,  1497,     0, 216861,  18290, 235151
179609,15031, 0.0102452, 0.0000000, 0.0102107,  6274,     0, 612383,   2070, 614453
179609,15029, 0.3461274, 0.0000000, 0.3419079, 59852,     0, 172919,   2134, 175053
179610,15099, 0.0002260, 0.0000000, 0.0002084,    49,     0, 216861,  18290, 235151
179632,29040, 0.0065304, 0.0000000, 0.0023525,    23,     0,   3522,   6255,   9777
179632,29024, 0.0175857, 0.0000000, 0.0102674,   258,     0,  14671,  10457,  25128
179633,29040, 0.6428166, 0.0000000, 0.2315639,  2264,     0,   3522,   6255,   9777
179634,29040, 0.0042589, 0.0000000, 0.0015342,    15,     0,   3522,   6255,   9777
179635,29005, 0.0461753, 0.0000000, 0.0446190,  3413,     0,  73914,   2578,  76492
179636,29043, 0.0013512, 0.0000000, 0.0011487,    38,     0,  28123,   4958,  33081
179636,29038, 0.0141868, 0.0000000, 0.0116351,   170,     0,  11983,   2628,  14611
179636,29026, 0.0499319, 0.0000000, 0.0387912,   697,     0,  13959,   4009,  17968
179636,29005, 0.4365885, 0.0000000, 0.4218742, 32270,     0,  73914,   2578,  76492
179637,29026, 0.0078802, 0.0000000, 0.0061220,   110,     0,  13959,   4009,  17968
179637,29005, 0.0040588, 0.0000000, 0.0039220,   300,     0,  73914,   2578,  76492
179638,29039, 0.0115930, 0.0000000, 0.0106574,   232,     0,  20012,   1757,  21769
179639,29039, 0.4600739, 0.0000000, 0.4229409,  9207,     0,  20012,   1757,  21769
179639,29035, 0.0339684, 0.0000000, 0.0338164,   189,     0,   5564,     25,   5589
179640,29039, 0.1364681, 0.0000000, 0.1254536,  2731,     0,  20012,   1757,  21769
179640,29035, 0.8537024, 0.0000000, 0.8498837,  4750,     0,   5564,     25,   5589
179641,29035, 0.0001797, 0.0000000, 0.0001789,     1,     0,   5564,     25,   5589
180642,15106, 0.0098290, 0.0000000, 0.0090951,  7454,     0, 758370,  61191, 819561
180645,15067, 0.0018361, 0.0000000, 0.0009214,    72,     0,  39213,  38933,  78146
180655,15037, 0.0001558, 0.0000000, 0.0001363,    33,     0, 211875,  30292, 242167
180656,15057, 0.2665124, 0.0000000, 0.2587124,215709,     0, 809377,  24402, 833779
180657,9016 , 0.0389633, 0.0000000, 0.0389633, 14529,     0, 372889,      0, 372889
180657,15057, 0.0513914, 0.0000000, 0.0498873, 41595,     0, 809377,  24402, 833779
180658,9016 , 0.3731459, 0.0000000, 0.3731459,139142,     0, 372889,      0, 372889
180658,9002 , 0.0029997, 0.0000000, 0.0029997,  1244,     0, 414711,      0, 414711
180659,9016 , 0.1942964, 0.0000000, 0.1942964, 72451,     0, 372889,      0, 372889
180659,9015 , 0.1144142, 0.0000000, 0.1144142, 60849,     0, 531831,      0, 531831
180659,9002 , 0.0236092, 0.0000000, 0.0236092,  9791,     0, 414711,      0, 414711
180660,9015 , 0.3493629, 0.0000000, 0.3493629,185802,     0, 531831,      0, 531831
180661,9017 , 0.3042220, 0.0000000, 0.3042220,131113,     0, 430978,      0, 430978
180661,9015 , 0.0335558, 0.0000000, 0.0335558, 17846,     0, 531831,      0, 531831
180661,9005 , 0.0315988, 0.0000000, 0.0315988, 37469,     0,1185772,      0,1185772
180662,9017 , 0.1262895, 0.0000000, 0.1262895, 54428,     0, 430978,      0, 430978
180662,9005 , 0.0294315, 0.0000000, 0.0294315, 34899,     0,1185772,      0,1185772
180663,9017 , 0.0081048, 0.0000000, 0.0081048,  3493,     0, 430978,      0, 430978
180663,9005 , 0.0351906, 0.0000000, 0.0351906, 41728,     0,1185772,      0,1185772
180664,15058, 0.0132783, 0.0000000, 0.0132068, 14667,     0,1104585,   5980,1110565
180665,15031, 0.0027417, 0.0000000, 0.0027325,  1679,     0, 612383,   2070, 614453
180667,15031, 0.1930279, 0.0000000, 0.1923776,118207,     0, 612383,   2070, 614453
180668,15031, 0.0055798, 0.0000000, 0.0055610,  3417,     0, 612383,   2070, 614453
180669,15029, 0.0211197, 0.0000000, 0.0208623,  3652,     0, 172919,   2134, 175053
180692,29040, 0.3182851, 0.0000000, 0.1146569,  1121,     0,   3522,   6255,   9777
180693,29043, 0.0373004, 0.0000000, 0.0317100,  1049,     0,  28123,   4958,  33081
180694,29005, 0.0179668, 0.0000000, 0.0173613,  1328,     0,  73914,   2578,  76492
180695,29043, 0.0666358, 0.0000000, 0.0566488,  1874,     0,  28123,   4958,  33081
180695,29031, 0.0577421, 0.0000000, 0.0504520,  1451,     0,  25129,   3631,  28760
180696,29038, 0.0097638, 0.0000000, 0.0080077,   117,     0,  11983,   2628,  14611
180696,29031, 0.2214175, 0.0000000, 0.1934631,  5564,     0,  25129,   3631,  28760
180696,29005, 0.1173661, 0.0000000, 0.1134106,  8675,     0,  73914,   2578,  76492
180697,29039, 0.0009994, 0.0000000, 0.0009187,    20,     0,  20012,   1757,  21769
180697,29031, 0.0123363, 0.0000000, 0.0107789,   310,     0,  25129,   3631,  28760
180708,29004, 0.0002614, 0.0000000, 0.0000628,     1,     0,   3826,  12109,  15935
181698,15005, 0.0075272, 0.0000000, 0.0030138,   445,     0,  59119,  88534, 147653
181702,15106, 0.0000000, 0.0000000, 0.0000000,     0,     0, 758370,  61191, 819561
181705,15087, 0.0102570, 0.0000000, 0.0041773,   376,     0,  36658,  53352,  90010
181715,15057, 0.0876909, 0.0000000, 0.0851245, 70975,     0, 809377,  24402, 833779
181716,9016 , 0.0002843, 0.0000000, 0.0002843,   106,     0, 372889,      0, 372889
181716,9002 , 0.0629016, 0.0000000, 0.0629016, 26086,     0, 414711,      0, 414711
181716,15057, 0.0573107, 0.0000000, 0.0556334, 46386,     0, 809377,  24402, 833779
181717,9016 , 0.0162837, 0.0000000, 0.0162837,  6072,     0, 372889,      0, 372889
181717,9002 , 0.2279395, 0.0000000, 0.2279395, 94529,     0, 414711,      0, 414711
181717,15057, 0.0051892, 0.0000000, 0.0050373,  4200,     0, 809377,  24402, 833779
181718,9015 , 0.0020702, 0.0000000, 0.0020702,  1101,     0, 531831,      0, 531831
181718,9002 , 0.2483440, 0.0000000, 0.2483440,102991,     0, 414711,      0, 414711
181719,9015 , 0.0338754, 0.0000000, 0.0338754, 18016,     0, 531831,      0, 531831
181719,9005 , 0.0576679, 0.0000000, 0.0576679, 68381,     0,1185772,      0,1185772
181719,9002 , 0.0751005, 0.0000000, 0.0751005, 31145,     0, 414711,      0, 414711
181720,9015 , 0.0003629, 0.0000000, 0.0003629,   193,     0, 531831,      0, 531831
181720,9005 , 0.0976638, 0.0000000, 0.0976638,115807,     0,1185772,      0,1185772
181721,9005 , 0.1207964, 0.0000000, 0.1207964,143237,     0,1185772,      0,1185772
181722,9005 , 0.0295293, 0.0000000, 0.0295293, 35015,     0,1185772,      0,1185772
181722,15058, 0.1060579, 0.0000000, 0.1054868,117150,     0,1104585,   5980,1110565
181723,15058, 0.0254467, 0.0000000, 0.0253096, 28108,     0,1104585,   5980,1110565
181723,15033, 0.0004314, 0.0000000, 0.0004311,   714,     0,1655015,   1092,1656107
181730,15099, 0.0184819, 0.0000000, 0.0170444,  4008,     0, 216861,  18290, 235151
181732,15099, 0.0021581, 0.0000000, 0.0019902,   468,     0, 216861,  18290, 235151
181749,29014, 0.0002561, 0.0000000, 0.0001441,     2,     0,   7809,   6070,  13879
181751,29011, 0.0285152, 0.0000000, 0.0135356,    58,     0,   2034,   2251,   4285
181752,29011, 0.0117994, 0.0000000, 0.0056009,    24,     0,   2034,   2251,   4285
181753,29031, 0.0148036, 0.0000000, 0.0129346,   372,     0,  25129,   3631,  28760
181755,29031, 0.2998130, 0.0000000, 0.2619610,  7534,     0,  25129,   3631,  28760
181760,29030, 0.0620988, 0.0000000, 0.0365154,   503,     0,   8100,   5675,  13775
182774,15057, 0.0788668, 0.0000000, 0.0765587, 63833,     0, 809377,  24402, 833779
182775,9002 , 0.0093680, 0.0000000, 0.0093680,  3885,     0, 414711,      0, 414711
182775,15104, 0.0202461, 0.0000000, 0.0202431, 13446,     0, 664127,     98, 664225
182775,15057, 0.0445071, 0.0000000, 0.0432045, 36023,     0, 809377,  24402, 833779
182776,9002 , 0.2917815, 0.0000000, 0.2917815,121005,     0, 414711,      0, 414711
182776,15104, 0.0448348, 0.0000000, 0.0448282, 29776,     0, 664127,     98, 664225
182777,9005 , 0.0087723, 0.0000000, 0.0087723, 10402,     0,1185772,      0,1185772
182777,9002 , 0.0578427, 0.0000000, 0.0578427, 23988,     0, 414711,      0, 414711
182777,15104, 0.0466101, 0.0000000, 0.0466032, 30955,     0, 664127,     98, 664225
182778,9005 , 0.0523355, 0.0000000, 0.0523355, 62058,     0,1185772,      0,1185772
182778,9002 , 0.0001109, 0.0000000, 0.0001109,    46,     0, 414711,      0, 414711
182779,9005 , 0.0841536, 0.0000000, 0.0841536, 99787,     0,1185772,      0,1185772
182779,15104, 0.0185070, 0.0000000, 0.0185043, 12291,     0, 664127,     98, 664225
182780,9005 , 0.1176466, 0.0000000, 0.1176466,139502,     0,1185772,      0,1185772
182780,15104, 0.0054718, 0.0000000, 0.0054710,  3634,     0, 664127,     98, 664225
182780,15033, 0.0212729, 0.0000000, 0.0212589, 35207,     0,1655015,   1092,1656107
182781,9005 , 0.0071860, 0.0000000, 0.0071860,  8521,     0,1185772,      0,1185772
182781,15058, 0.0362661, 0.0000000, 0.0360708, 40059,     0,1104585,   5980,1110565
182781,15033, 0.0563149, 0.0000000, 0.0562778, 93202,     0,1655015,   1092,1656107
182782,15058, 0.0017310, 0.0000000, 0.0017216,  1912,     0,1104585,   5980,1110565
182782,15033, 0.0887557, 0.0000000, 0.0886972,146892,     0,1655015,   1092,1656107
182787,15099, 0.1541679, 0.0000000, 0.1421767, 33433,     0, 216861,  18290, 235151
182791,15099, 0.0299039, 0.0000000, 0.0275780,  6485,     0, 216861,  18290, 235151
182792,15099, 0.0000092, 0.0000000, 0.0000085,     2,     0, 216861,  18290, 235151
182801,29020, 0.5414265, 0.0000000, 0.4989379,  4228,     0,   7809,    665,   8474
182802,29020, 0.0591625, 0.0000000, 0.0545197,   462,     0,   7809,    665,   8474
182810,29011, 0.4301868, 0.0000000, 0.2042007,   875,     0,   2034,   2251,   4285
182819,29030, 0.2702469, 0.0000000, 0.1589111,  2189,     0,   8100,   5675,  13775
182820,29030, 0.2893827, 0.0000000, 0.1701633,  2344,     0,   8100,   5675,  13775
183807,15074, 0.0094698, 0.0000000, 0.0036986,   449,     0,  47414,  73982, 121396
183808,15074, 0.0393344, 0.0000000, 0.0153629,  1865,     0,  47414,  73982, 121396
183814,15042, 0.0032233, 0.0000000, 0.0019154,   271,     0,  84075,  57407, 141482
183816,15042, 0.0085400, 0.0000000, 0.0050749,   718,     0,  84075,  57407, 141482
183829,15046, 0.1124140, 0.0000000, 0.0490818,   882,     0,   7846,  10124,  17970
183831,15013, 0.0058406, 0.0000000, 0.0058314,  2857,     0, 489160,    777, 489937
183832,15013, 0.0022528, 0.0000000, 0.0022493,  1102,     0, 489160,    777, 489937
183833,15104, 0.0080602, 0.0000000, 0.0080590,  5353,     0, 664127,     98, 664225
183833,15057, 0.0094863, 0.0000000, 0.0092087,  7678,     0, 809377,  24402, 833779
183834,15104, 0.1191007, 0.0000000, 0.1190831, 79098,     0, 664127,     98, 664225
183834,15057, 0.0022029, 0.0000000, 0.0021385,  1783,     0, 809377,  24402, 833779
183834,15013, 0.0141263, 0.0000000, 0.0141039,  6910,     0, 489160,    777, 489937
183835,15104, 0.0910007, 0.0000000, 0.0909872, 60436,     0, 664127,     98, 664225
183836,9005 , 0.0396611, 0.0000000, 0.0396611, 47029,     0,1185772,      0,1185772
183836,15104, 0.1097892, 0.0000000, 0.1097730, 72914,     0, 664127,     98, 664225
183837,9005 , 0.1124575, 0.0000000, 0.1124575,133349,     0,1185772,      0,1185772
183837,15104, 0.0149565, 0.0000000, 0.0149543,  9933,     0, 664127,     98, 664225
183838,9005 , 0.0002850, 0.0000000, 0.0002850,   338,     0,1185772,      0,1185772
183838,15104, 0.1207013, 0.0000000, 0.1206835, 80161,     0, 664127,     98, 664225
183839,15104, 0.0483417, 0.0000000, 0.0483345, 32105,     0, 664127,     98, 664225
183839,15033, 0.0309762, 0.0000000, 0.0309557, 51266,     0,1655015,   1092,1656107
183840,15033, 0.0885956, 0.0000000, 0.0885372,146627,     0,1655015,   1092,1656107
183841,15033, 0.0965043, 0.0000000, 0.0964406,159716,     0,1655015,   1092,1656107
183846,15099, 0.1416760, 0.0000000, 0.1306565, 30724,     0, 216861,  18290, 235151
183879,29030, 0.0018519, 0.0000000, 0.0010889,    15,     0,   8100,   5675,  13775
184872,15042, 0.0488255, 0.0000000, 0.0290143,  4105,     0,  84075,  57407, 141482
184886,15060, 0.0008873, 0.0000000, 0.0008020,   294,     0, 331351,  35251, 366602
184887,15060, 0.0002113, 0.0000000, 0.0001909,    70,     0, 331351,  35251, 366602
184891,15013, 0.0236978, 0.0000000, 0.0236602, 11592,     0, 489160,    777, 489937
184892,15013, 0.1232419, 0.0000000, 0.1230464, 60285,     0, 489160,    777, 489937
184893,15104, 0.0458903, 0.0000000, 0.0458835, 30477,     0, 664127,     98, 664225
184893,15013, 0.0972851, 0.0000000, 0.0971309, 47588,     0, 489160,    777, 489937
184894,15104, 0.0745430, 0.0000000, 0.0745320, 49506,     0, 664127,     98, 664225
184895,9005 , 0.0081904, 0.0000000, 0.0081904,  9712,     0,1185772,      0,1185772
184896,9005 , 0.1388808, 0.0000000, 0.1388808,164681,     0,1185772,      0,1185772
184896,15104, 0.0016352, 0.0000000, 0.0016350,  1086,     0, 664127,     98, 664225
184897,9005 , 0.0085371, 0.0000000, 0.0085371, 10123,     0,1185772,      0,1185772
184897,15033, 0.0008393, 0.0000000, 0.0008387,  1389,     0,1655015,   1092,1656107
184898,15104, 0.0137504, 0.0000000, 0.0137484,  9132,     0, 664127,     98, 664225
184898,15033, 0.0660634, 0.0000000, 0.0660199,109336,     0,1655015,   1092,1656107
184899,15033, 0.0518158, 0.0000000, 0.0517817, 85756,     0,1655015,   1092,1656107
184900,15033, 0.0742181, 0.0000000, 0.0741691,122832,     0,1655015,   1092,1656107
184904,15099, 0.0027621, 0.0000000, 0.0025473,   599,     0, 216861,  18290, 235151
184904,15030, 0.5960990, 0.0000000, 0.5678601, 12958,     0,  21738,   1081,  22819
184905,15099, 0.0144563, 0.0000000, 0.0133319,  3135,     0, 216861,  18290, 235151
184906,15069, 0.7801766, 0.0000000, 0.7668194,  3180,     0,   4076,     71,   4147
184906,15028, 0.0091808, 0.0000000, 0.0059181,   155,     0,  16883,   9308,  26191
184908,15099, 0.0052614, 0.0000000, 0.0048522,  1141,     0, 216861,  18290, 235151
184937,29047, 0.0665550, 0.0000000, 0.0574215,   159,     0,   2389,    380,   2769
184949,21044, 0.6022749, 0.0000000, 0.2067417,  3177,     0,   5275,  10092,  15367
185928,15042, 0.0066250, 0.0000000, 0.0039369,   557,     0,  84075,  57407, 141482
185929,15074, 0.0115156, 0.0000000, 0.0044977,   546,     0,  47414,  73982, 121396
185935,15042, 0.0014511, 0.0000000, 0.0008623,   122,     0,  84075,  57407, 141482
185948,15013, 0.0005888, 0.0000000, 0.0005878,   288,     0, 489160,    777, 489937
185949,15060, 0.0462772, 0.0000000, 0.0418274, 15334,     0, 331351,  35251, 366602
185949,15013, 0.0066216, 0.0000000, 0.0066111,  3239,     0, 489160,    777, 489937
185950,15060, 0.1045991, 0.0000000, 0.0945412, 34659,     0, 331351,  35251, 366602
185951,15013, 0.2516825, 0.0000000, 0.2512833,123113,     0, 489160,    777, 489937
185952,15121, 0.0000000, 0.0000000, 0.0000000,     0,     0, 501972,   9703, 511675
185952,15104, 0.0022556, 0.0000000, 0.0022553,  1498,     0, 664127,     98, 664225
185952,15013, 0.1723853, 0.0000000, 0.1721119, 84324,     0, 489160,    777, 489937
185953,15121, 0.0351075, 0.0000000, 0.0344418, 17623,     0, 501972,   9703, 511675
185953,15109, 0.0336260, 0.0000000, 0.0334380, 17524,     0, 521144,   2930, 524074
185953,15104, 0.0499227, 0.0000000, 0.0499153, 33155,     0, 664127,     98, 664225
185954,15104, 0.0011850, 0.0000000, 0.0011848,   787,     0, 664127,     98, 664225
185955,9005 , 0.0184310, 0.0000000, 0.0184310, 21855,     0,1185772,      0,1185772
185956,9005 , 0.0015846, 0.0000000, 0.0015846,  1879,     0,1185772,      0,1185772
185956,15033, 0.0008217, 0.0000000, 0.0008212,  1360,     0,1655015,   1092,1656107
185957,15033, 0.0118126, 0.0000000, 0.0118048, 19550,     0,1655015,   1092,1656107
185958,15033, 0.0543016, 0.0000000, 0.0542658, 89870,     0,1655015,   1092,1656107
185959,15033, 0.0366571, 0.0000000, 0.0366329, 60668,     0,1655015,   1092,1656107
185960,15033, 0.0121431, 0.0000000, 0.0121351, 20097,     0,1655015,   1092,1656107
185960,15002, 0.1307476, 0.0000000, 0.1244160, 16990,     0, 129945,   6613, 136558
185961,15011, 0.2373920, 0.0000000, 0.1646249,  9259,     0,  39003,  17240,  56243
185961,15002, 0.0405710, 0.0000000, 0.0386063,  5272,     0, 129945,   6613, 136558
185963,15030, 0.1152820, 0.0000000, 0.1098208,  2506,     0,  21738,   1081,  22819
185963,15028, 0.2405378, 0.0000000, 0.1550533,  4061,     0,  16883,   9308,  26191
185964,15069, 0.0250245, 0.0000000, 0.0245961,   102,     0,   4076,     71,   4147
185964,15030, 0.0560769, 0.0000000, 0.0534204,  1219,     0,  21738,   1081,  22819
185965,15069, 0.1886654, 0.0000000, 0.1854353,   769,     0,   4076,     71,   4147
185978,29020, 0.0329107, 0.0000000, 0.0303281,   257,     0,   7809,    665,   8474
186982,15124, 0.0000000, 0.0000000, 0.0000000,     0,     0,   6681,  84664,  91345
186983,15074, 0.0838149, 0.0000000, 0.0327358,  3974,     0,  47414,  73982, 121396
186986,15074, 0.0131185, 0.0000000, 0.0051237,   622,     0,  47414,  73982, 121396
186988,15042, 0.0014154, 0.0000000, 0.0008411,   119,     0,  84075,  57407, 141482
186989,15042, 0.0165923, 0.0000000, 0.0098599,  1395,     0,  84075,  57407, 141482
186994,15042, 0.0030211, 0.0000000, 0.0017953,   254,     0,  84075,  57407, 141482
187005,15060, 0.0002022, 0.0000000, 0.0001828,    67,     0, 331351,  35251, 366602
187008,15060, 0.2142532, 0.0000000, 0.1936514, 70993,     0, 331351,  35251, 366602
187009,15121, 0.0006714, 0.0000000, 0.0006586,   337,     0, 501972,   9703, 511675
187009,15060, 0.2058361, 0.0000000, 0.1860437, 68204,     0, 331351,  35251, 366602
187009,15013, 0.0033527, 0.0000000, 0.0033474,  1640,     0, 489160,    777, 489937
187010,15121, 0.0196943, 0.0000000, 0.0193209,  9886,     0, 501972,   9703, 511675
187010,15060, 0.0001268, 0.0000000, 0.0001146,    42,     0, 331351,  35251, 366602
187010,15013, 0.1022344, 0.0000000, 0.1020723, 50009,     0, 489160,    777, 489937
187011,15121, 0.0499550, 0.0000000, 0.0490077, 25076,     0, 501972,   9703, 511675
187011,15013, 0.0612867, 0.0000000, 0.0611895, 29979,     0, 489160,    777, 489937
187012,15121, 0.0881922, 0.0000000, 0.0865198, 44270,     0, 501972,   9703, 511675
187012,15109, 0.0104827, 0.0000000, 0.0104241,  5463,     0, 521144,   2930, 524074
187013,15109, 0.2044771, 0.0000000, 0.2033339,106562,     0, 521144,   2930, 524074
187014,15109, 0.0574333, 0.0000000, 0.0571122, 29931,     0, 521144,   2930, 524074
187016,15020, 0.0608867, 0.0000000, 0.0608637, 16924,     0, 277959,    105, 278064
187017,15081, 0.0115484, 0.0000000, 0.0113062,  4122,     0, 356932,   7647, 364579
187018,15081, 0.0349927, 0.0000000, 0.0342587, 12490,     0, 356932,   7647, 364579
187018,15033, 0.0675184, 0.0000000, 0.0674739,111744,     0,1655015,   1092,1656107
187019,15033, 0.0521282, 0.0000000, 0.0520939, 86273,     0,1655015,   1092,1656107
187019,15002, 0.1311170, 0.0000000, 0.1247675, 17038,     0, 129945,   6613, 136558
187020,15100, 0.2800181, 0.0000000, 0.2633598,  9270,     0,  33105,   2094,  35199
187020,15011, 0.0418686, 0.0000000, 0.0290347,  1633,     0,  39003,  17240,  56243
187020,15002, 0.2504367, 0.0000000, 0.2383090, 32543,     0, 129945,   6613, 136558
187021,15002, 0.0703067, 0.0000000, 0.0669020,  9136,     0, 129945,   6613, 136558
187022,15002, 0.1159337, 0.0000000, 0.1103194, 15065,     0, 129945,   6613, 136558
187023,15028, 0.0046200, 0.0000000, 0.0029781,    78,     0,  16883,   9308,  26191
187031,29006, 0.0728600, 0.0000000, 0.0583391,  2614,     0,  35877,   8930,  44807
187037,29020, 0.1102574, 0.0000000, 0.1016049,   861,     0,   7809,    665,   8474
187038,29045, 0.0007050, 0.0000000, 0.0007034,     4,     0,   5674,     13,   5687
188043,15074, 0.0156494, 0.0000000, 0.0061122,   742,     0,  47414,  73982, 121396
188050,15042, 0.0001546, 0.0000000, 0.0000919,    13,     0,  84075,  57407, 141482
188052,15042, 0.0142968, 0.0000000, 0.0084958,  1202,     0,  84075,  57407, 141482
188057,15056, 0.1090530, 0.0000000, 0.0478435,  1360,     0,  12471,  15955,  28426
188067,15060, 0.1407118, 0.0000000, 0.1271815, 46625,     0, 331351,  35251, 366602
188068,15060, 0.0413459, 0.0000000, 0.0373702, 13700,     0, 331351,  35251, 366602
188069,15121, 0.0570032, 0.0000000, 0.0559222, 28614,     0, 501972,   9703, 511675
188070,15121, 0.1584829, 0.0000000, 0.1554776, 79554,     0, 501972,   9703, 511675
188071,15121, 0.0958998, 0.0000000, 0.0940812, 48139,     0, 501972,   9703, 511675
188071,15109, 0.0083758, 0.0000000, 0.0083290,  4365,     0, 521144,   2930, 524074
188071,15024, 0.0125114, 0.0000000, 0.0113167,  1585,     0, 126684,  13375, 140059
188072,15109, 0.0634834, 0.0000000, 0.0631285, 33084,     0, 521144,   2930, 524074
188072,15024, 0.0075148, 0.0000000, 0.0067971,   952,     0, 126684,  13375, 140059
188073,15109, 0.1104762, 0.0000000, 0.1098585, 57574,     0, 521144,   2930, 524074
188073,15020, 0.0145165, 0.0000000, 0.0145110,  4035,     0, 277959,    105, 278064
188074,15109, 0.0007157, 0.0000000, 0.0007117,   373,     0, 521144,   2930, 524074
188074,15020, 0.3354487, 0.0000000, 0.3353221, 93241,     0, 277959,    105, 278064
188075,15033, 0.0163944, 0.0000000, 0.0163836, 27133,     0,1655015,   1092,1656107
188075,15020, 0.2425430, 0.0000000, 0.2424514, 67417,     0, 277959,    105, 278064
188076,15081, 0.0553075, 0.0000000, 0.0541474, 19741,     0, 356932,   7647, 364579
188076,15033, 0.0243732, 0.0000000, 0.0243571, 40338,     0,1655015,   1092,1656107
188077,15081, 0.2198178, 0.0000000, 0.2152071, 78460,     0, 356932,   7647, 364579
188077,15033, 0.0072205, 0.0000000, 0.0072157, 11950,     0,1655015,   1092,1656107
188078,15081, 0.0007396, 0.0000000, 0.0007241,   264,     0, 356932,   7647, 364579
188078,15033, 0.0606333, 0.0000000, 0.0605933,100349,     0,1655015,   1092,1656107
188078,15002, 0.0006695, 0.0000000, 0.0006371,    87,     0, 129945,   6613, 136558
188079,15033, 0.0023359, 0.0000000, 0.0023344,  3866,     0,1655015,   1092,1656107
189107,15042, 0.0941183, 0.0000000, 0.0559294,  7913,     0,  84075,  57407, 141482
189109,15042, 0.0057568, 0.0000000, 0.0034209,   484,     0,  84075,  57407, 141482
189126,15060, 0.0000543, 0.0000000, 0.0000491,    18,     0, 331351,  35251, 366602
189127,15121, 0.0035938, 0.0000000, 0.0035257,  1804,     0, 501972,   9703, 511675
189129,15121, 0.1751293, 0.0000000, 0.1718083, 87910,     0, 501972,   9703, 511675
189130,15121, 0.0287088, 0.0000000, 0.0281644, 14411,     0, 501972,   9703, 511675
189130,15024, 0.0552161, 0.0000000, 0.0499432,  6995,     0, 126684,  13375, 140059
189131,15121, 0.0000637, 0.0000000, 0.0000625,    32,     0, 501972,   9703, 511675
189131,15109, 0.0024485, 0.0000000, 0.0024348,  1276,     0, 521144,   2930, 524074
189131,15024, 0.5077516, 0.0000000, 0.4592636, 64324,     0, 126684,  13375, 140059
189132,15109, 0.0056242, 0.0000000, 0.0055927,  2931,     0, 521144,   2930, 524074
189132,15024, 0.0703009, 0.0000000, 0.0635875,  8906,     0, 126684,  13375, 140059
189133,15020, 0.1446472, 0.0000000, 0.1445926, 40206,     0, 277959,    105, 278064
189134,15109, 0.1503673, 0.0000000, 0.1495266, 78363,     0, 521144,   2930, 524074
189134,15044, 0.5581510, 0.0000000, 0.5581510, 14695,     0,  26328,      0,  26328
189134,15033, 0.0037414, 0.0000000, 0.0037389,  6192,     0,1655015,   1092,1656107
189134,15020, 0.1456546, 0.0000000, 0.1455996, 40486,     0, 277959,    105, 278064
189135,15081, 0.0148236, 0.0000000, 0.0145126,  5291,     0, 356932,   7647, 364579
189135,15044, 0.0205105, 0.0000000, 0.0205105,   540,     0,  26328,      0,  26328
189135,15033, 0.0034483, 0.0000000, 0.0034460,  5707,     0,1655015,   1092,1656107
189137,15033, 0.0067450, 0.0000000, 0.0067405, 11163,     0,1655015,   1092,1656107
189138,15081, 0.0258341, 0.0000000, 0.0252922,  9221,     0, 356932,   7647, 364579
189138,15033, 0.0000000, 0.0000000, 0.0000000,     0,     0,1655015,   1092,1656107
189141,15092, 0.1264042, 0.0000000, 0.1010375,  5356,     0,  42372,  10638,  53010
189167,29034, 0.0462110, 0.0000000, 0.0208568,   833,     0,  18026,  21913,  39939
190174,15056, 0.0059338, 0.0000000, 0.0026033,    74,     0,  12471,  15955,  28426
190188,15121, 0.1366710, 0.0000000, 0.1340792, 68605,     0, 501972,   9703, 511675
190188,15095, 0.0242998, 0.0000000, 0.0203593,  1803,     0,  74198,  14361,  88559
190189,15121, 0.0509271, 0.0000000, 0.0499614, 25564,     0, 501972,   9703, 511675
190189,15095, 0.0002695, 0.0000000, 0.0002258,    20,     0,  74198,  14361,  88559
190190,15121, 0.0060740, 0.0000000, 0.0059589,  3049,     0, 501972,   9703, 511675
190191,15108, 0.4584198, 0.0000000, 0.4476843, 41101,     0,  89658,   2150,  91808
190191,15053, 0.3728503, 0.0000000, 0.3120024, 15675,     0,  42041,   8199,  50240
190191,15024, 0.1165972, 0.0000000, 0.1054627, 14771,     0, 126684,  13375, 140059
190193,15109, 0.0704162, 0.0000000, 0.0700226, 36697,     0, 521144,   2930, 524074
190196,15081, 0.1437305, 0.0000000, 0.1407157, 51302,     0, 356932,   7647, 364579
190198,15081, 0.0079371, 0.0000000, 0.0077706,  2833,     0, 356932,   7647, 364579
190201,15075, 0.0750859, 0.0000000, 0.0387107,   962,     0,  12812,  12039,  24851
190212,13021, 0.0000000, 0.0000000, 0.0000000,     0,     0,   8722,   4635,  13357
191215,15124, 0.0812753, 0.0000000, 0.0059445,   543,     0,   6681,  84664,  91345
191221,15048, 0.0424357, 0.0000000, 0.0213385,  1306,     0,  30776,  30428,  61204
191222,15048, 0.0000000, 0.0000000, 0.0000000,     0,     0,  30776,  30428,  61204
191224,15042, 0.0035682, 0.0000000, 0.0021204,   300,     0,  84075,  57407, 141482
191225,15042, 0.0010943, 0.0000000, 0.0006503,    92,     0,  84075,  57407, 141482
191226,15014, 0.0005976, 0.0000000, 0.0003094,    29,     0,  48528,  45190,  93718
191227,15014, 0.0046983, 0.0000000, 0.0024328,   228,     0,  48528,  45190,  93718
191228,15048, 0.0030218, 0.0000000, 0.0015195,    93,     0,  30776,  30428,  61204
191248,15121, 0.0126103, 0.0000000, 0.0123711,  6330,     0, 501972,   9703, 511675
191248,15095, 0.1206906, 0.0000000, 0.1011190,  8955,     0,  74198,  14361,  88559
191248,15091, 0.0013181, 0.0000000, 0.0012042,    76,     0,  57659,   5456,  63115
191249,15121, 0.0006136, 0.0000000, 0.0006019,   308,     0, 501972,   9703, 511675
191249,15091, 0.0677778, 0.0000000, 0.0619187,  3908,     0,  57659,   5456,  63115
191250,15108, 0.0024315, 0.0000000, 0.0023745,   218,     0,  89658,   2150,  91808
192279,15048, 0.0020470, 0.0000000, 0.0010293,    63,     0,  30776,  30428,  61204
192281,15048, 0.0449701, 0.0000000, 0.0226129,  1384,     0,  30776,  30428,  61204
192286,15014, 0.0060378, 0.0000000, 0.0031264,   293,     0,  48528,  45190,  93718
192306,15023, 0.0076240, 0.0000000, 0.0069690,   272,     0,  35677,   3353,  39030
192307,15091, 0.4153038, 0.0000000, 0.3794027, 23946,     0,  57659,   5456,  63115
192307,15023, 0.0704375, 0.0000000, 0.0643864,  2513,     0,  35677,   3353,  39030
192308,15091, 0.3337553, 0.0000000, 0.3049037, 19244,     0,  57659,   5456,  63115
192309,15091, 0.0002081, 0.0000000, 0.0001901,    12,     0,  57659,   5456,  63115
192310,15044, 0.2321483, 0.0000000, 0.2321483,  6112,     0,  26328,      0,  26328
192311,15044, 0.1360909, 0.0000000, 0.1360909,  3583,     0,  26328,      0,  26328
192312,15059, 0.0446000, 0.0000000, 0.0305754,  1051,     0,  23565,  10809,  34374
192314,15120, 0.0238606, 0.0000000, 0.0200693,  3204,     0, 134280,  25367, 159647
192315,15120, 0.0032395, 0.0000000, 0.0027248,   435,     0, 134280,  25367, 159647
192327,15016, 0.1012124, 0.0000000, 0.0591181,  1511,     0,  14929,  10630,  25559
193341,15048, 0.0393488, 0.0000000, 0.0197863,  1211,     0,  30776,  30428,  61204
193347,15014, 0.0000412, 0.0000000, 0.0000213,     2,     0,  48528,  45190,  93718
193364,15095, 0.0119545, 0.0000000, 0.0100159,   887,     0,  74198,  14361,  88559
193365,15023, 0.4536816, 0.0000000, 0.4147066, 16186,     0,  35677,   3353,  39030
193367,15024, 0.0001737, 0.0000000, 0.0001571,    22,     0, 126684,  13375, 140059
193368,15024, 0.0055808, 0.0000000, 0.0050479,   707,     0, 126684,  13375, 140059
193369,15044, 0.0362352, 0.0000000, 0.0362352,   954,     0,  26328,      0,  26328
193370,15044, 0.0168642, 0.0000000, 0.0168642,   444,     0,  26328,      0,  26328
193372,15120, 0.0829610, 0.0000000, 0.0697789, 11140,     0, 134280,  25367, 159647
193373,15081, 0.0466784, 0.0000000, 0.0456993, 16661,     0, 356932,   7647, 364579
193375,15084, 0.0037701, 0.0000000, 0.0029455,   106,     0,  28116,   7871,  35987
193376,15084, 0.2645113, 0.0000000, 0.2066580,  7437,     0,  28116,   7871,  35987
193380,15016, 0.0002010, 0.0000000, 0.0001174,     3,     0,  14929,  10630,  25559
193383,15061, 0.1661067, 0.0000000, 0.1389545,  1236,     0,   7441,   1454,   8895
193387,13061, 0.2790639, 0.0000000, 0.2365864, 12223,     0,  43800,   7864,  51664
194398,15085, 0.0207505, 0.0000000, 0.0092352,   579,     0,  27903,  34792,  62695
194408,15056, 0.0153155, 0.0000000, 0.0067192,   191,     0,  12471,  15955,  28426
194420,13063, 0.0057694, 0.0000000, 0.0039696,   320,     0,  55465,  25147,  80612
194426,15120, 0.0629208, 0.0000000, 0.0529230,  8449,     0, 134280,  25367, 159647
194427,15120, 0.0468722, 0.0000000, 0.0394245,  6294,     0, 134280,  25367, 159647
194428,15120, 0.1939827, 0.0000000, 0.1631600, 26048,     0, 134280,  25367, 159647
194429,15120, 0.0940349, 0.0000000, 0.0790932, 12627,     0, 134280,  25367, 159647
194431,15081, 0.0015465, 0.0000000, 0.0015141,   552,     0, 356932,   7647, 364579
194433,13069, 0.0198285, 0.0000000, 0.0183355,  1787,     0,  90123,   7338,  97461
194434,13069, 0.0001110, 0.0000000, 0.0001026,    10,     0,  90123,   7338,  97461
194440,15016, 0.1284748, 0.0000000, 0.0750421,  1918,     0,  14929,  10630,  25559
194443,15061, 0.0001344, 0.0000000, 0.0001124,     1,     0,   7441,   1454,   8895
195469,15026, 0.0182545, 0.0000000, 0.0084570,   233,     0,  12764,  14787,  27551
195470,15026, 0.0967565, 0.0000000, 0.0448260,  1235,     0,  12764,  14787,  27551
195480,15035, 0.0006044, 0.0000000, 0.0005399,    54,     0,  89351,  10672, 100023
195491,13069, 0.2081822, 0.0000000, 0.1925078, 18762,     0,  90123,   7338,  97461
195492,13069, 0.0876580, 0.0000000, 0.0810581,  7900,     0,  90123,   7338,  97461
195501,15061, 0.2085741, 0.0000000, 0.1744801,  1552,     0,   7441,   1454,   8895
195539,21207, 0.0063639, 0.0000000, 0.0031710,   169,     0,  26556,  26739,  53295
196527,15026, 0.1764337, 0.0000000, 0.0817393,  2252,     0,  12764,  14787,  27551
196540,15035, 0.0080133, 0.0000000, 0.0071584,   716,     0,  89351,  10672, 100023
196541,15035, 0.1281687, 0.0000000, 0.1144937, 11452,     0,  89351,  10672, 100023
196547,15036, 0.0430882, 0.0000000, 0.0342163,  1364,     0,  31656,   8208,  39864
196548,15036, 0.0571456, 0.0000000, 0.0453793,  1809,     0,  31656,   8208,  39864
196559,15016, 0.0683234, 0.0000000, 0.0399077,  1020,     0,  14929,  10630,  25559
196561,13083, 0.1445378, 0.0000000, 0.0659122,  2580,     0,  17850,  21293,  39143
196597,21207, 0.0027866, 0.0000000, 0.0013885,    74,     0,  26556,  26739,  53295
197573,15085, 0.0675913, 0.0000000, 0.0300821,  1886,     0,  27903,  34792,  62695
197600,15035, 0.0052937, 0.0000000, 0.0047289,   473,     0,  89351,  10672, 100023
197602,15035, 0.0325570, 0.0000000, 0.0290833,  2909,     0,  89351,  10672, 100023
197603,15096, 0.0529820, 0.0000000, 0.0455363,  1544,     0,  29142,   4765,  33907
197605,15120, 0.0091227, 0.0000000, 0.0076732,  1225,     0, 134280,  25367, 159647
197606,15036, 0.0600518, 0.0000000, 0.0476871,  1901,     0,  31656,   8208,  39864
197607,15036, 0.1089525, 0.0000000, 0.0865192,  3449,     0,  31656,   8208,  39864
197609,13069, 0.0048711, 0.0000000, 0.0045044,   439,     0,  90123,   7338,  97461
197612,13069, 0.0000111, 0.0000000, 0.0000103,     1,     0,  90123,   7338,  97461
197613,15084, 0.1020415, 0.0000000, 0.0797232,  2869,     0,  28116,   7871,  35987
197614,13066, 0.0321009, 0.0000000, 0.0220525,   257,     0,   8006,   3648,  11654
197614,15084, 0.0213046, 0.0000000, 0.0166449,   599,     0,  28116,   7871,  35987
197656,21207, 0.0000753, 0.0000000, 0.0000375,     2,     0,  26556,  26739,  53295
198635,15001, 0.0089422, 0.0000000, 0.0012476,    76,     0,   8499,  52419,  60918
198662,15096, 0.2452131, 0.0000000, 0.2107529,  7146,     0,  29142,   4765,  33907
198663,15096, 0.3830554, 0.0000000, 0.3292241, 11163,     0,  29142,   4765,  33907
198664,15036, 0.0024640, 0.0000000, 0.0019567,    78,     0,  31656,   8208,  39864
198665,15036, 0.1235469, 0.0000000, 0.0981086,  3911,     0,  31656,   8208,  39864
198668,15036, 0.0026535, 0.0000000, 0.0021072,    84,     0,  31656,   8208,  39864
198669,13069, 0.0057366, 0.0000000, 0.0053047,   517,     0,  90123,   7338,  97461
199691,15085, 0.0161631, 0.0000000, 0.0071936,   451,     0,  27903,  34792,  62695
199695,15001, 0.3408636, 0.0000000, 0.0475557,  2897,     0,   8499,  52419,  60918
199714,13063, 0.0143694, 0.0000000, 0.0098869,   797,     0,  55465,  25147,  80612
199717,13063, 0.0797620, 0.0000000, 0.0548802,  4424,     0,  55465,  25147,  80612
199721,15096, 0.0008579, 0.0000000, 0.0007373,    25,     0,  29142,   4765,  33907
199726,15036, 0.0802060, 0.0000000, 0.0636915,  2539,     0,  31656,   8208,  39864
199728,15036, 0.0099823, 0.0000000, 0.0079270,   316,     0,  31656,   8208,  39864
200775,13063, 0.0000721, 0.0000000, 0.0000496,     4,     0,  55465,  25147,  80612
200776,13063, 0.0023618, 0.0000000, 0.0016251,   131,     0,  55465,  25147,  80612
200777,13013, 0.1724174, 0.0000000, 0.1051548,  3268,     0,  18954,  12124,  31078
200779,13013, 0.0005804, 0.0000000, 0.0003539,    11,     0,  18954,  12124,  31078
200790,13082, 0.0851314, 0.0000000, 0.0844422,  1523,     0,  17890,    146,  18036
200834,21202, 0.4390752, 0.0000000, 0.1891583,  2317,     0,   5277,   6972,  12249
201826,15079, 0.1642174, 0.0000000, 0.0596711,   704,     0,   4287,   7511,  11798
201832,13063, 0.0486613, 0.0000000, 0.0334814,  2699,     0,  55465,  25147,  80612
201842,15036, 0.0031590, 0.0000000, 0.0025085,   100,     0,  31656,   8208,  39864
201843,15036, 0.1775019, 0.0000000, 0.1409542,  5619,     0,  31656,   8208,  39864
201852,13083, 0.1744538, 0.0000000, 0.0795545,  3114,     0,  17850,  21293,  39143
202884,15079, 0.0296244, 0.0000000, 0.0107645,   127,     0,   4287,   7511,  11798
202885,15079, 0.7140191, 0.0000000, 0.2594508,  3061,     0,   4287,   7511,  11798
202886,15079, 0.0921390, 0.0000000, 0.0334802,   395,     0,   4287,   7511,  11798
202894,13013, 0.0076501, 0.0000000, 0.0046657,   145,     0,  18954,  12124,  31078
202895,13010, 0.0459738, 0.0000000, 0.0372435,  1002,     0,  21795,   5109,  26904
202896,13010, 0.0475338, 0.0000000, 0.0385073,  1036,     0,  21795,   5109,  26904
202908,13082, 0.0032979, 0.0000000, 0.0032712,    59,     0,  17890,    146,  18036
202909,13082, 0.2587479, 0.0000000, 0.2566534,  4629,     0,  17890,    146,  18036
202911,13083, 0.2781513, 0.0000000, 0.1268426,  4965,     0,  17850,  21293,  39143
202914,13051, 0.0014826, 0.0000000, 0.0013186,   168,     0, 113312,  14092, 127404
202945,21162, 0.1750939, 0.0000000, 0.1427898,   606,     0,   3461,    783,   4244
202946,21162, 0.0228258, 0.0000000, 0.0186145,    79,     0,   3461,    783,   4244
203968,13082, 0.2147010, 0.0000000, 0.2129630,  3841,     0,  17890,    146,  18036
203971,13048, 0.0000000, 0.0000000, 0.0000000,     0,     0, 262513,   5349, 267862
203991,21008, 0.0072310, 0.0000000, 0.0016257,    17,     0,   2351,   8106,  10457
205013,13074, 0.1643412, 0.0000000, 0.1567008,  4193,     0,  25514,   1244,  26758
205013,13010, 0.1803166, 0.0000000, 0.1460749,  3930,     0,  21795,   5109,  26904
205016,13065, 0.0000000, 0.0000000, 0.0000000,     0,     0,   8705,   2407,  11112
205017,13005, 0.1064567, 0.0000000, 0.0864263,  1474,     0,  13846,   3209,  17055
205029,13051, 0.0829215, 0.0000000, 0.0737496,  9396,     0, 113312,  14092, 127404
205030,13048, 0.0009790, 0.0000000, 0.0009594,   257,     0, 262513,   5349, 267862
205032,13051, 0.0489886, 0.0000000, 0.0435701,  5551,     0, 113312,  14092, 127404
205041,13077, 0.0039350, 0.0000000, 0.0034502,   523,     0, 132909,  18675, 151584
205044,13077, 0.0343769, 0.0000000, 0.0301417,  4569,     0, 132909,  18675, 151584
205045,13077, 0.0000075, 0.0000000, 0.0000066,     1,     0, 132909,  18675, 151584
205061,21006, 0.1746548, 0.0000000, 0.0437170,   645,     0,   3693,  11061,  14754
205064,21028, 0.0099150, 0.0000000, 0.0056543,    14,     0,   1412,   1064,   2476
205069,21084, 0.1590354, 0.0000000, 0.0764939,   521,     0,   3276,   3535,   6811
206072,13074, 0.1840558, 0.0000000, 0.1754989,  4696,     0,  25514,   1244,  26758
206074,13074, 0.0336286, 0.0000000, 0.0320652,   858,     0,  25514,   1244,  26758
206076,13065, 0.1311890, 0.0000000, 0.1027718,  1142,     0,   8705,   2407,  11112
206076,13005, 0.3694930, 0.0000000, 0.2999707,  5116,     0,  13846,   3209,  17055
206086,13048, 0.0086472, 0.0000000, 0.0084745,  2270,     0, 262513,   5349, 267862
206088,13048, 0.0766210, 0.0000000, 0.0750909, 20114,     0, 262513,   5349, 267862
206089,13051, 0.0202273, 0.0000000, 0.0179900,  2292,     0, 113312,  14092, 127404
206089,13048, 0.0699508, 0.0000000, 0.0685540, 18363,     0, 262513,   5349, 267862
206090,13048, 0.0128070, 0.0000000, 0.0125512,  3362,     0, 262513,   5349, 267862
206120,21006, 0.5104252, 0.0000000, 0.1277620,  1885,     0,   3693,  11061,  14754
206121,21006, 0.0008123, 0.0000000, 0.0002033,     3,     0,   3693,  11061,  14754
206129,21029, 0.9663021, 0.0000000, 0.8623055,  3269,     0,   3383,    408,   3791
207108,15003, 0.1028071, 0.0000000, 0.0128282,   575,     0,   5593,  39230,  44823
207127,13076, 0.0224334, 0.0000000, 0.0159451,  1657,     0,  73863,  30056, 103919
207133,13074, 0.0533433, 0.0000000, 0.0508633,  1361,     0,  25514,   1244,  26758
207145,13048, 0.0029218, 0.0000000, 0.0028634,   767,     0, 262513,   5349, 267862
207149,13051, 0.0697631, 0.0000000, 0.0620467,  7905,     0, 113312,  14092, 127404
207168,13002, 0.0858055, 0.0000000, 0.0357785,  1452,     0,  16922,  23661,  40583
207177,21049, 0.0009004, 0.0000000, 0.0001903,     3,     0,   3332,  12435,  15767
208194,13005, 0.0463672, 0.0000000, 0.0376429,   642,     0,  13846,   3209,  17055
208195,13005, 0.2308248, 0.0000000, 0.1873937,  3196,     0,  13846,   3209,  17055
208206,13052, 0.0214079, 0.0000000, 0.0087656,   281,     0,  13126,  18931,  32057
208219,13077, 0.0000527, 0.0000000, 0.0000462,     7,     0, 132909,  18675, 151584
208222,13077, 0.0001505, 0.0000000, 0.0001319,    20,     0, 132909,  18675, 151584
208224,13077, 0.0088105, 0.0000000, 0.0077251,  1171,     0, 132909,  18675, 151584
208235,21183, 0.0478765, 0.0000000, 0.0245637,   487,     0,  10172,   9654,  19826
209226,15003, 0.0497050, 0.0000000, 0.0062022,   278,     0,   5593,  39230,  44823
209246,13067, 0.1062163, 0.0000000, 0.0716918,  3443,     0,  32415,  15610,  48025
209256,13005, 0.1174346, 0.0000000, 0.0953386,  1626,     0,  13846,   3209,  17055
209258,13003, 0.0007120, 0.0000000, 0.0004972,    27,     0,  37919,  16380,  54299
209259,13003, 0.0298004, 0.0000000, 0.0208107,  1130,     0,  37919,  16380,  54299
209265,13052, 0.0093707, 0.0000000, 0.0038369,   123,     0,  13126,  18931,  32057
209283,13077, 0.0091341, 0.0000000, 0.0080088,  1214,     0, 132909,  18675, 151584
209287,13002, 0.1113344, 0.0000000, 0.0464234,  1884,     0,  16922,  23661,  40583
210308,13067, 0.0133580, 0.0000000, 0.0090161,   433,     0,  32415,  15610,  48025
210314,13005, 0.0000000, 0.0000000, 0.0000000,     0,     0,  13846,   3209,  17055
210315,13005, 0.0000000, 0.0000000, 0.0000000,     0,     0,  13846,   3209,  17055
210325,13038, 0.0000000, 0.0000000, 0.0000000,     0,     0,    481,   7499,   7980
210326,13038, 0.3866944, 0.0000000, 0.0233083,   186,     0,    481,   7499,   7980
210352,21071, 0.0393367, 0.0000000, 0.0281014,  2747,     0,  69833,  27920,  97753
211367,13041, 0.0944551, 0.0000000, 0.0623570,  2671,     0,  28278,  14556,  42834
211368,13050, 0.0406039, 0.0000000, 0.0319575,   710,     0,  17486,   4731,  22217
211368,13041, 0.6174765, 0.0000000, 0.4076435, 17461,     0,  28278,  14556,  42834
211375,13023, 0.0259983, 0.0000000, 0.0164007,   556,     0,  21386,  12515,  33901
211414,21183, 0.1483484, 0.0000000, 0.0761122,  1509,     0,  10172,   9654,  19826
211424,30050, 0.2427885, 0.0000000, 0.0651949,  1010,     0,   4160,  11332,  15492
212427,13050, 0.0257349, 0.0000000, 0.0202548,   450,     0,  17486,   4731,  22217
212427,13041, 0.0018035, 0.0000000, 0.0011906,    51,     0,  28278,  14556,  42834
212434,13023, 0.0436734, 0.0000000, 0.0275508,   934,     0,  21386,  12515,  33901
212435,13054, 0.0810811, 0.0000000, 0.0168431,   552,     0,   6808,  25965,  32773
212466,21100, 0.0153755, 0.0000000, 0.0026785,    26,     0,   1691,   8016,   9707
212481,30051, 0.0016641, 0.0000000, 0.0006416,    14,     0,   8413,  13409,  21822
213495,13003, 0.2808355, 0.0000000, 0.1961178, 10649,     0,  37919,  16380,  54299
213538,30037, 0.0003559, 0.0000000, 0.0002561,     2,     0,   5619,   2191,   7810
214545,13019, 0.0025554, 0.0000000, 0.0001721,     3,     0,   1174,  16262,  17436
214553,13054, 0.1784665, 0.0000000, 0.0370732,  1215,     0,   6808,  25965,  32773
214564,13012, 0.0678970, 0.0000000, 0.0182999,   493,     0,   7261,  19679,  26940
215583,13029, 0.0027075, 0.0000000, 0.0009717,    43,     0,  15882,  28371,  44253
215604,13019, 0.0008518, 0.0000000, 0.0000574,     1,     0,   1174,  16262,  17436
215643,21178, 0.8094956, 0.0000000, 0.0796962,  1364,     0,   1685,  15430,  17115
216636,22016, 0.2025838, 0.0000000, 0.1491566, 36051,     0, 177956,  63743, 241699
216637,22016, 0.2886837, 0.0000000, 0.2125495, 51373,     0, 177956,  63743, 241699
216643,13029, 0.0045964, 0.0000000, 0.0016496,    73,     0,  15882,  28371,  44253
217690,22016, 0.0010958, 0.0000000, 0.0008068,   195,     0, 177956,  63743, 241699
217701,13029, 0.0039038, 0.0000000, 0.0014010,    62,     0,  15882,  28371,  44253
219812,22016, 0.0075749, 0.0000000, 0.0055772,  1348,     0, 177956,  63743, 241699
219837,13030, 0.0012833, 0.0000000, 0.0006021,    52,     0,  40521,  45842,  86363
219838,13030, 0.0437551, 0.0000000, 0.0205296,  1773,     0,  40521,  45842,  86363
219839,13030, 0.0377582, 0.0000000, 0.0177159,  1530,     0,  40521,  45842,  86363
220869,22012, 0.0119872, 0.0000000, 0.0093956,   601,     0,  50137,  13829,  63966
220950,21194, 0.1159538, 0.0000000, 0.0870921,  2429,     0,  20948,   6942,  27890
225106,22017, 0.0038163, 0.0000000, 0.0028858,   183,     0,  47952,  15461,  63413
226165,22017, 0.0525108, 0.0000000, 0.0397079,  2518,     0,  47952,  15461,  63413
227271,13081, 0.0024216, 0.0000000, 0.0017264,    56,     0,  23125,   9312,  32437
